type octile
height 41
width 73
map
@@@@@@@@@@@@@@@@TTTTTTTTTTTTTTTTTTTTTTTTTTTTTTTTTTTTTTTTTTTTTTTTTTTTTTTTT
@@@@@@@@@@@@@@@@TTTTTTTTTTTTTTTTTTTTTTTTTTTTTTTTTTTTTTTTTTTTTTTTTTTTTTTTT
@@@@@@@@@@@@@@@@TTTTT..TT.............TTT.TTTTTTTTTTTTTTTT.....TTTTTTTTTT
@@@@@@@@@@@@@@@@TTTTT..TT.............TTT..TTTTTTTTTTTT........TTTTTTTTTT
@@@@@@@@@@@@@@@@TTTTT..TTT............TTT...TTTTTTTTTTT........TTTTTTTTTT
@@@@@@@@@@@@@@@@TTT....TTT..................TTTTTTTTTTT................TT
@@@@@@@@@@@@@@@@TTT....TTT...TTTTTTT..........TTTTTTTTT...............TTT
@@@@@@@@@@@@@@@@TTTT...TTT...TTTTTTT...........TTTTTTTT...............TTT
@@@@@@@@@@@@@@@@TTTT.........TTTTTTTTT.........TTT.....................TT
@@@@@@@@@@@@@@@@TTTT.........TTTTTTTTT.........TTT.....................TT
@@@@@@@@@@@@@@@@TTTT.........TTTTTTTTT........TTTT.....................TT
@@@@@@@@@@@@@@@@TTTT..........................TTTT....................TTT
@@@@@@@@@@@@@@@@TTTT...........................TTT....................TTT
@@@@@@@@@@@@@@@@TTTT.....................TTTTTTTTTTTTT................TTT
@@@@@@@@@@@@@@@@TTTT...............TTTTTTTTTTTTTTTTTTT................TTT
@@@@@@@@@@@@@@@@TTTTTTTTTTT..TTTTTTTTTTTTTTTTTTTTTTTTTTTTT.............TT
@@@@@@@@@@@@@@@@TTTTTTTTTTT..TTTTTTTTTTTTTTTTTTTTTTTTTTTTT.............TT
@@@@@@@@@@@@@@@@TTTTTTTTTTT..TTTTTTTTTTTTTTTTTTTTTTTTTTTTT..........TTTTT
@@@@@@@@@@@@@@@@TT.................TTT...TTTTTTTTTTTTTTTTT..........TTTTT
@@@@@@@@@@@@@@@@TT.................TTT.............TTTTTTT..........TTTTT
@@@@@@@@@@@@@@@@TT..................................TTTTTT..........TTTTT
@@@@@@@@@@@@@@@@TT..........................TT.......TTTTT......TT..TTTTT
@@@@@@@@@@@@@@@@TT....................................TTTT......TT..TTTTT
@@@@@@@@@@@@@@@@TT....................................TTTT.....TTT.....TT
TTTTTTTTTTTTTTTTTT.....................................TTT.....TT......TT
TTTTTTTTTTTTTTTTTT.....................................TTT............TTT
TTTTTTTTTT.............................................TTT............TTT
TTTTTT......................TT......TT................................TTT
TT....................TTTTTTTTTTTTTTTTTTTTTT..........................TTT
TT....................TTTTTTTTTTTTTTTTTTTTTT............TT............TTT
TT....................TTTTTTTTTTTTTTTTTTTTTT...........TTT......TTTTT.TTT
TT.............TTT....TTTTTTTTTTTTTTTTTTTTTT....TTTTTTTTTTTTTTTTTTTTTTTTT
TT.............TTT....TTTTTTTTTTTTTTTTTTTTTT...TTTTTTTTTTTTTTTTTTTTTTTTTT
TT.............TTT.......TT......TT...TT.......TT@@@@@@@@@@@@@@@@@@@@@@@@
TT.............TTT...............TT............TTTT@@@@@@@@@@@@@@@@@@@@@@
TT.............TTT.............................TTTT@@@@@@@@@@@@@@@@@@@@@@
TT.............TTT.............................TTTT@@@@@@@@@@@@@@@@@@@@@@
TTTT...........TTT.............................TTTT@@@@@@@@@@@@@@@@@@@@@@
TTTTTT.........TTT.TT..........................TTTT@@@@@@@@@@@@@@@@@@@@@@
TTTTTTTTTTT..TTTTTTTTTTTTTTTTTTTTTTTTTTTTTTTTTTTTTT@@@@@@@@@@@@@@@@@@@@@@
TTTTTTTTTTT..TTTTTTTTTTTTTTTTTTTTTTTTTTTTTTTTTTTTTT@@@@@@@@@@@@@@@@@@@@@@
