type octile
height 66
width 66
map
@@@@@@@@@@@@@@@@@@@@@@@@@@@@@@@@@@@@@@@@@@@@@@@@@@@@@TTTTTTTTT@@@@
@@@@@@@@@@@@@@@@@@@@@@@@@@@@@@@@@@@@@@@@TTTTTTTTTTTTTTTTTTTTTTTTTT
@@@@@@@@@@@@@@@@@@@@@@@@@@@@@@@@@@@@@@@@TTTTTT.....TTTT.......TTTT
@@@@@@@@@@@@@@@@@@@@@@@@@@@@@@@@@@@@@@@@TTT..T.....T@@T......T@@TT
@@@@@@@@@@@@@@@@@@@@@@@@@@@@@@@@@@@@@@@@TTT..T..T.TT@@T......T@TTT
@@@@@@@@@@@@@@@@@@@@@@@@@@@@@@@@@@@@@@@@TTT........TTTT.......TTTT
@@@@@@@@@@@@@@@@@@@@@@@@@@@@@@@@@@@@@@@@TTT.....T.T............TTT
@@@@@@@@@@@@@@@@@@@@@@@@@@@@@@@@@@@@@@@@TTT....................TTT
@@@@@@@@@@@@@@@@@@@@@@@@@@@@@@@@@@@@@@@@TTT....................TTT
@TTTTTTTTTTTTTTT......TTTTTTTTTTTTTTT@@@TTT....................TTT
TTTTTT..TTT@TTTTTT..TTTTTTTTTTTTT..TT@@@TTT.....................TT
TTTT....TTTTTTTTTT..TTTTTTTTTTTTT..TT@@@TT.....TTTT.............TT
TTTT....TTTT...TTT..TTTTT..........TTT@@TT.....TTTTTTT..........TT
TTTT.....TT...........TTT...........TT@@TT.....TTTTTTT..........TT
TT....................TTT...........TT@@TT.....TTTTTTT..........TT
TT..................................TT@@TT......................TT
TT..................................TT@@TT......................TT
TTT.................................TT@@TT......................TT
TTT.................................TT@@TT......................TT
TTT.................................TT@@TT......................TT
TTT.................................TT@@TT......................TT
TT..................................T@@@TT.......TTT..TTTT......TT
@T..................................T@@@TTTTTTTTTTTT..TTTTTTTTTTTT
@T..................................TTTTTTTTTTTTTTTT..TTTTTTTTTTTT
@T..................................TTTTT.......TTTT..TTTT@@@@@@TT
@T....................................TTT...............TTTT@@@@TT
@T....................................TTT...............TTTT@TTTTT
@T.......................................................TTTTTTTTT
@T..............................................................TT
@T..............................................................TT
@T..............................................................TT
@T..............................................................TT
@T..........TT......TT......TT..................................TT
@T..........TT......TT......TT..................................TT
@T...................T..........................................TT
@T...........................TTTTTTT...........TTTT.............TT
TT...........................TTTTTTT...........TTTT.............TT
TT.............................................TTTT.............TT
TT.......TTTTTTTT..............................TTTT...........TTTT
TT.......TTTTTTTT.............................................TTTT
TT....................................TT......................TTTT
TT....................................TT........................TT
TT....................................TT........................TT
TT..............................................................TT
TT..............................................................TT
TT..............................................................TT
TT..............................................................TT
TT.............................................TTTT.............TT
TT.............................................TTTT.............TT
TT.............................................TTTT.............TT
TT....................................TT.......TTTT....TTTTT....TT
TT....................................TT...............TTTTT....TT
TT....................................TT...............TTTT..TTTTT
TT.....................................................TTTTTTTTTTT
TT.....................................................TTTTTTTTTTT
TT.....................................................TTTT@@TTTTT
@T....TT..........TT.......TTT............................TTTTTTTT
@T....TT..........TT......TTTT............................TTTTTTTT
@T....TT..........TT......TTTT..........................TTTT@@@@@@
@T.....................................................TTTTT@@@@@@
@T.................................TTT....TTTTTTT.......TT@@@@@@@@
@TT........TT.............T.....TTTTTTTTTTTTTTTTTTTTTTTTTT@@@@@@@@
@TTTTT.....TTTT.....TTTTTTT...TTTT@@@@@@@@@@@@@@@@@@@@@@@@@@@@@@@@
@TTTTTTTT..TTTT.....TTTTTTT...TTTT@@@@@@@@@@@@@@@@@@@@@@@@@@@@@@@@
@TT@@TTTTTTTTTTT..TTTTTTTTTTTTTTTT@@@@@@@@@@@@@@@@@@@@@@@@@@@@@@@@
@TTTTTTTTTTTTTTT..TTTTTTTTTTTTTTTT@@@@@@@@@@@@@@@@@@@@@@@@@@@@@@@@
