type octile
height 37
width 37
map
@@@@@@@@@@@@@TTT@@@@TT@@@@@@@@@@@@@@@
@@@@@@@TTTTTTTTT@@@@TTTTTT@@@@@@@@@@@
@TTTTTTTTTT..TTTT..TTT..TT@@@@@@@@@@@
@TTTTTTTTTT.............TT@@@@@@@@@@@
@TTTTTTTTTT.............TT@@@@@@@@@@@
@TTTTTTTTTT............TTT@@@@@@@@@@@
@TT...................TTTT@@@@@@@@@@@
@TT...................TTTT@@@@@@@@@@@
TTT.......TTT..........TTT@@@@@@@@@@@
TTT.......TTT...........TT@@@@@@@@@@@
TTT......TTTTT..........TT@@@@@@@@@@@
@TT.....TTTTTTT.........TT@@@@@@@@@@@
@TT......TTTTTT.........TT@@@@@@@@@@@
@TT......TTTTTT.........TT@@@@@@@@@@@
@TT....................TTT@@@@@@@@@@@
@TT.....................TT@@@@@@@@@@@
@TT......................T@@@@@@@@@@@
@TT......................T@@@@@@@@@@@
@TT......................TTTTTTTTTT@@
@TT......................TTTTTTTTTT@@
@TT......................TTTTTTTTTTT@
@TTTT....................TTTTTTTTTTT@
@TTTT....................TTTTTTTTTTT@
@TTTT........TTTT...........TTTT...T@
@TTTT......TTTTTT...........TTTT...T@
@TTTTTT....TTTTTT..................T@
@@@@@TTTTTT@TTTTT..................T@
@@@@@@TTTTT@@T@@T..................T@
@@@@@@TTTTTTTT@@T..................T@
@@@@@@TTTTTTTT@@T..................T@
@@@@@@@@@@@@@@@@TTTTTTT............T@
@@@@@@@@@@@@@@@TTTTTTTT............T@
@@@@@@@@@@@@@@@TTTTTTTTTTT..TTT....T@
@@@@@@@@@@@@@@@TTTTTTTTTTT.TTTTTTT.T@
@@@@@@@@@@@@@@@TTTTTTTTTTT.TTTTTTT.T@
@@@@@@@@@@@@@@@TTTTTTTTTTTTTTTTTTTTTT
@@@@@@@@@@@@@@@@@@@TTTTTTTTTTTTTTTTT@
