type octile
height 88
width 100
map
@@@@@@@@@@@@@@@@@@@@@@@TTTTTTTTTTTTTTTTTTTTT.......TTTTTTTTTTTTTTTTT@@@@@@@@@@@@@@@@@@@@@@@@@@@@@@@@
@@@@@@@@@@@@@@@@@@@@@@@TTTTTTTTTTTTTTTTTTTTT......TTTTTTTTTTTTTTTTTT@@@@@@@@@@@@@@@@@@@@@@@@@@@@@@@@
@@@@@@@@@@@@@@@@@@@@@@@@@@TTTTTTTTTTTTTTTTTT......TTTTT.TTTTTTTTTTT@@@@@@@@@@@@@@@@@@@@@@@@@@@@@@@@@
@@@@@@@@@@@@@@@@@@@@@@@@@@TTTTT...........TT......TT...........TTTT@@@@@@@@@@@@@@@@@@@@@@@@@@@@@@@@@
@@@@@@@@@@@@@@@@@@@@@@@@@@TTTT.................................TTTT@@@@@@@@@@@@@@@@@@@@@@@@@@@@@@@@@
@@@@@@@@@@@@@@@@@@@@@@@@@@TT...................................TTTT@@@@@@@@@@@@@@@@@@@@@@@@@@@@@@@@@
@@@@@@@@@@@@@@@@@@@@@@@@@@TTT.........TTTT.........TTTT........TTTT@@@@@@@@@@@@@@@@@@@@@@@@@@@@@@@@@
@@@@@@@@@@@@@@@@@@@@@@@@@@TTT.........TTTT.........TTTT........TTTT@@@@@@@@@@@@@@@@@@@@@@@@@@@@@@@@@
@@@@@@@@@@@@@@@@@@@@@@@@@@TTTT........TTTT.........TTTT........TTTT@@@@@@@@@@@@@@@@@@@@@@@@@@@@@@@@@
@@@@@@@@@@@@@@@@@@@@@@@@@@TTTTT.......TTTT.........TTTT........TTTT@@@@@@@@@@@@@@@@@@@@@@@@@@@@@@@@@
@@@@@@@@@@@@@@@@@@@@@@@@@@TTTTTTTT....TTTT.........TTTT.........TTT@@@@@@@@@@@@@@@@@@@@@@@@@@@@@@@@@
@@@@@@@@@@@@@@@@@@@@@@@@@@TTTTTTTT..............................TTT@@@@@@@@@@@@@@@@@@@@@@@@@@@@@@@@@
@@@@@@@@@@@@@@@@@@@@@@@@@@TTTTT.................................TTT@@@@@@@@@@@@@@@@@@@@@@@@@@@@@@@@@
@@@@@@@@@@@@@@@@@@@@@@@@@@TTTTTT...TT.TTTT.........TTTT..TTTT...TTT@@@@@@@@@@@@@@@@@@@@@@@@@@@@@@@@@
@@@@@@@@@@@@@@@@@@@@@@@@TTTTTTTTTTTTTTTTTTT.......TTTTT.TTTTTT.TTTTT@@@@@@@@@@@@@@@@@@@@@@@@@@@@@@@@
@@@@@@@@@@@@@@@@@@@@@@@@TTTTTTTTTTTTTTTTTTT.......TTTTTTTTTTTTTTTTTT@@@@@@@@@@@@@@@@@@@@@@@@@@@@@@@@
@@@@@@@@@@@@@@@@@@@@@@@TTTTTTTTTTTTTTTTTTTT.......TTTTTTTTTTTTTTTTTT@@@@@@@@@@@@@@@@@@@@@@@@@@@@@@@@
@@@@@@@@@@@@@@@@@@@@@@@TTTTTTTTTTTTTTTTTTTT.......TTTTTTTTTTTTTTTTTT@@@@@@@@@@@@@@@@@@@@@@@@@@@@@@@@
@@@@@@@@@@@@@@@@@@@@@@@@TTTTTTTTTTTTTTTTTTT.......TTTTT..TTTTTTTTTTT@@@@@@@@@@@@@@@@@@@@@@@@@@@@@@@@
@@@@@@@@@@@@@@@@@@@@@@@@@@TTTT...TTTTT.TT..........TT....T..TTT...TT@@@@@@@@@@@@@@@@@@@@@@@@@@@@@@@@
@@@@@@@@@@@@@@@@@@@@@@@@@@TT......TTTT............................TT@@@@@@@@@@@@@@@@@@@@@@@@@@@@@@@@
@@@@@@@@@@@@@@@@@@@@@@@@@@TTTTT...TT..............................TT@@@@@@@@@@@@@@@@@@@@@@@@@@@@@@@@
@@@@@@@@@@@@@@@@@@@@@@@@@@TTTTTT..................................TT@@@@@@@@@@@@@@@@@@@@@@@@@@@@@@@@
@@@@@@@@@@@@@@@@@@@@@@@@@@TTTTTT................................TTTT@@@@@@@@@@@@@@@@@@@@@@@@@@@@@@@@
@@@@@@@@@@@@@@@@@@@@@@@@@@TT@TTT...............................TTTTT@@@@@@@@@@@@@@@@@@@@@@@@@@@@@@@@
@@@@@@@@@@@@@@@@@@@@@@@@@@TTTTTT...............................TTTTT@@@@@@@@@@@@@@@@@@@@@@@@@@@@@@@@
@@@@@@@@@@@@@@@@@@@@@@@@@@TTTTTT................................TTTT@@@@@@@@@@@@@@@@@@@@@@@@@@@@@@@@
@@@@@@@@@@@@@@@@@@@@@@@@@@TTTTTT...............................TTTTT@@@@@@@@@@@@@@@@@@@@@@@@@@@@@@@@
@@@@@@@@@@@@@@@@@@@@@@@@@@TTTTTT..............................TTTTTT@@@@@@@@@@@@@@@@@@@@@@@@@@@@@@@@
@@@@@@@@@@@@@@@@@@@@@@@@@@TTTTTT...............................TTTTT@@@@@@@@@@@@@@@@@@@@@@@@@@@@@@@@
@@@@@@@@@@@@@@@@@@@@@@@@@@TTTTTT................................TTTT@@@@@@@@@@@@@@@@@@@@@@@@@@@@@@@@
@@@@@@@@@@@@@@@@@@@@@@@@@@TT@TT.................................TTTT@@@@@@@@@@@@@@@@@@@@@@@@@@@@@@@@
@@@@@@@@@@@@@@@@@@@@@@@@@@TTTTTT...............................TTTTT@@@@@@@@@@@@@@@@@@@@@@@@@@@@@@@@
@@@@@@@@@@@@@@@@@@@@@@@@@@TTTTTT................................TTTT@@@@@@@@@@@@@@@@@@@@@@@@@@@@@@@@
@@@@@@@@@@@@@@@@@@@@@@@@@@TTTT.................................TTTTT@@@@@@@@@@@@@@@@@@@@@@@@@@@@@@@@
@@@@@@@@@@@@@@@@@@@@@@@@@@TTT..................................TTTTT@@@@@@@@@@@@@@@@@@@@@@@@@@@@@@@@
@@@@@@@@@@@@@@@@@@@@@@@@@@TTTT................................TTTTTT@@@@@@@@@@@@@@@@@@@@@@@@@@@@@@@@
@@@@@@@@@@@@@@@@@@@@@@@@@@TT..................................TTTTTT@@@@@@@@@@@@@@@@@@@@@@@@@@@@@@@@
@@@@@@@@@@@@@@@@@@@@@@@@@@TT..................................TTTTTT@@@@@@@@@@@@@@@@@@@@@@@@@@@@@@@@
@@@@@@@@@@@@@@@@@@@@@@@@@@TT..................................TTTTTT@@@@@@@@@@@@@@@@@@@@@@@@@@@@@@@@
@@@@@@@@@@@@@@@@@@@@@@@@@@TTTTTT............................TTTTTTTT@@@@@@@@@@@@@@@@@@@@@@@@@@@@@@@@
@@@@@@@@@@@@@@@@@@@@@@@@@@TTTTTTTT..........................TTTTTTTT@@@@@@@@@@@@@@@@@@@@@@@@@@@@@@@@
@@@@@@@@@@@@@@@@@@@@@@@@@@TTTTTTTT............................TTTTTT@@@@@@@@@@@@@@@@@@@@@@@@@@@@@@@@
@@@@@@@@@@@@@@@@@@@@@@@@@@TTTTTTTT................................TT@@@@@@@@@@@@@@@@@@@@@@@@@@@@@@@@
@@@@@@@@@@@@@@@@@@@@@@@@@@TTTTTTTT...............................TTT@@@@@@@@@@@@@@@@@@@@@@@@@@@@@@@@
@@@@@@@@@@@@@@@@@@@@@@@@@@TTTTTT................................TTTT@@@@@@@@@@@@@@@@@@@@@@@@@@@@@@@@
@@@@@@@@@@@@@@@@@@@@@@@@@@TTTTTT................................TTTT@@@@@@@@@@@@@@@@@@@@@@@@@@@@@@@@
@@@@@@@@@@@@@@@@@@@@@@@@@@TTTTTT.................................TTT@@@@@@@@@@@@@@@@@@@@@@@@@@@@@@@@
@@@@@@@@@@@@@@@@@@@@@@@@@@TTTT...................................TTT@@@@@@@@@@@@@@@@@@@@@@@@@@@@@@@@
@@@@@@@@@@@@@@@@@@@@@@@@@@TT.....................................TTT@@@@@@@@@@@@@@@@@@@@@@@@@@@@@@@@
@@@@@@@@@@@@@@@@@@@@@@@@@@TT.....................................TTT@@@@@@@@@@@@@@@@@@@@@@@@@@@@@@@@
@@@@@@@@@@@@@@@@@@@@@@@@TTTTTTTT..................................TT@@@@@@@@@@@@@@@@@@@@@@@@@@@@@@@@
TTTTTT@@@@@@@@@@@@@@@@@@TTTTTTTTT.................................TT@@@@@@@@@@@@@@@@@@@@@@@@@@@@@@@@
TTTTTTTTTTTTTTTTTTTTTTTTTTTTTTTTT.................................TT@@@@@@@@@@@@@@@@@@@@@@@@@@@@@@@@
TTTTTTTTTTTTTTTTTTTTTTTTTTTTTTTTT..............................TTTTT@@@@@@@@@@@@@@@@@@@@@@@@@@@@@@@@
TTTTTTTTTTTTTTTTTTT.....TTTTTT................................TTTTTT@@@@@@@@@@@@@@@@@@@@@@@@@@@@@@@@
TTTTTTTTTTTTTTTTTTT......TTTT.................................TTTTTTTTTTTTTTTTTTTTTTTT@@@@@@@@@@@@@@
@@TTTTTTTTTTTTTTTTT...........................................TTTTTTTTTTTTT.TTTTTTTTTTTTT@@@@@@@@@@@
@@TTTTTTTTTTTT..................................................TTTTTT.TTTT.TTTTTTTTTTTTTTT@@@@@@@@@
@@TTTTTTTTTTT............TTTT............................................TT...TTTTTTTTTTTTTTTTTTT@@@
@@TTTTT..................TTTT......TTT..................TT.......................TTTT..TTTT@TTTTT@@@
@@TTT...................TTTTTT..TTTTTT....TTTTTTTTTT....TT.......TTTT...................TTTTTTTTT@@@
@@TT....................TTTTTTTTTTTTTT.................TTTTTT...TTTTTT.................TTTTTTTTTT@@@
@@TT....................TTTTTTTTTTTTTT.................TTTTTTTTTTTTTTT.................TTTTTTTTTT@@@
@@TT....................TTTTTTTTTTTTTT.................TTTTTTTTTTTTTTT.................TTT......TT@@
@@TTTTT.................TTTTTTTTTTTTTT.................TTTTTTTTTTTTTTT.................TTT......TT@@
@@TTTTT.......................T..TTTTTT................TTTTTTTTTTTTTTT..................TT.......T@@
@@TTTTT..........................TTTTTT.................TTTTTT....TTT...................TT.......TT@
@@TTTTT..........................TTTTT..................TTTTTT....TT....................TT........T@
@@TTTTT.........................TTTTTT.................TTTTTTT....TT....................TT........TT
@@TTTTT.........................TTTTTT................TTTTTTTT..........................TT.......TTT
@@TTTTT.........................TTTTTTT...TTTTTTTTTT..TTTTTTTT..........................TT.......TTT
@@TTTT..........................TTTTTTT...............TTTTTTTT..........................TT.......TTT
@@TT............................TTTTTTT................TTTTTTT..........................TT.......TTT
@@TT............................TTTTTT@TT..............TTTTTTTT.........................TT.......TTT
@@TT.....TTTT...................TTTTTT@TT..............TTTTT@TTTTTT....................TTT.......TTT
@@TTTT...TTTT.....................TTTTTTTTT.TTTTTT.TTTTTTTTTTTTTTTT....................TTT.......TTT
TTTTTT..TTTTTTT...................TTTTTTTTTTTTTTTTTTTTTT@TTTTTTTTTT...............TTTTTTT.......TTT@
TTTTTTTTTTTTTTTT.................TTTTTTTTTTTTTTTTTTTTT@TTTTTTTTTTTT...............TTTTT.........TTT@
TTTTTTTTTTTTTTTT.................TTTTTTTTTTTTTTTTTTTTTTTTTTTTTTTTT.............................TTT@@
@@@@TT@@TTTTTTTTTTT..............TTT@@@@@@@@@@@@@@@@TTTTTTTTTT.................................TTT@@
@@@@TT@@TTTTTTTTTTT..............TTT@@@@@@@@@@@@@@@@TT@TTTTTTTTT......TT..TT................TTTTTT@@
@@@@@@@@@@TTTTTTTTT..............TTT@@@@@@@@@@@@@@@@@@@TTTTTTTTT......TTTTTT....TTT.........TTTTT@@@
@@@@@@@@@@TTTTTTTTTT...TTT........TT@@@@@@@@@@@@@@@@@@@@@@TTTTT.....TTTTTTTTTT..TTT.........TTTTT@@@
@@@@@@@@@@TTTTTTTTTTT..TTTTTTTTTTTTT@@@@@@@@@@@@@@@@@@@@@@TTTTT....TTTTTTTTTTT..TTT......TTTTTTTT@@@
@@@@@@@@@@TTTTTTTTTTTTTTTTTTTTTTTTTT@@@@@@@@@@@@@@@@@@@@@@TTTTTT.TTTT@TTTTTTTT...TTTTT.TTTTTT@@@@@@@
@@@@@@@@TTTTTTTTTTTTTTTT@TTTTTTTTTTT@@@@@@@@@@@@@@@@@@@@@@TT@TTTTTTTTTTTTTTTTTTTTTTTTTTTTTTT@@@@@@@@
@@@@@@@@TTTTTTTTTTTTTTTTTTTTTTTTTTTT@@@@@@@@@@@@@@@@@@@@@@TTTTTTTTTTTTTTTTTTTTTTTTTTTTTTT@@@@@@@@@@@
