type octile
height 34
width 28
map
@@T@@T@@@@@@@@@@@@@@@@@@@@@@
@T@@@@T@@@@@@@@@@@@@@@@@@@@@
@@@TTTT@@@@@@@@@@@@@@@@@@@@@
@@@TTTTTTTTTTTTTTTTTTTTTTTTT
@T@TTT..................TTTT
@@TTTT....................TT
@@@TT.....................TT
@@@TT.....................TT
@@@TTT....................TT
@T@TTT.....TTTTT..........TT
T@@TTT.....TTTTT....T.....TT
T@TTTTTT...TTTTTTT.TTT....TT
T@TTTTTT...TTTTTTTTTTT....TT
@@@TTTTT...TTTTTTTTTTT....TT
@@TTTTTT...TTTTTTTTTTT....TT
@@@TTTTTTTTTTTTTTTTTTT....TT
@@@TTTTTTTTTTTTTTTTTTT....TT
@T@@@@@@@@TTT@@@@TTTTT....TT
@@@TTTTTTTTTTTTTTTTTT.....TT
@@@TTTTTTTTTTTTTTTTT......TT
@T@TTTTTTT................TT
@@TTTTTTTTT.............TTTT
@@@TTTTTTT..............TTTT
@@@TTTTTT...............TTTT
@@@TTTTTT..............TTTTT
@@@TTT@TT..............TTTTT
@@@TTTTTT..............TTTTT
@@@TT.T.T..............TTTTT
@@@TT...T...............T.TT
@@@TTTT...................TT
@@@TTTTTTTT..........TTTTTTT
@@@TTTTTTTTT.........TTTTTTT
@@@TTTT@TTTTTTT..TTTTTTTTTTT
@@@TTTTTTTTTTTT..TTTTTTTTTTT
