type octile
height 128
width 128
map
@@@@@@@@@@@@@@@@@@@@@@@@@@@@@@@@@TTTTTTTTTTTTTTTTTTTTTTTTT....TTTTTTTTTTTTTTTTTTTTTTTT@@@@@@@@@@@@@@@@@@@@@@@@@@@@@@@@@@@@@@@@@@
@@@@@@@@@@@@@@@@@@@@@@@@@@@@@@@@@TTTTTTTTT.......TTTTTTT........TTTTTTTTTTT..TTTTTTTTT@@@@@@@@@@@@@@@@@@@@@@@@@@@@@@@@@@@@@@@@@@
@@@@@@@@@@@@@@@@@@@@@@@@@@@@@@@@@TTTTTTTTTT......TTTTTTT........TTTTTTTTTTT...TTTTTTTT@@@@@@@@@@@@@@@@@@@@@@@@@@@@@@@@@@@@@@@@@@
@@@@@@@@@@@@@@@@@@@@@@@@@@@@@@@@@TTTTTTTTTTTT..................................TTTTTTT@@@@@@@@@@@@@@@@@@@@@@@@@@@@@@@@@@@@@@@@@@
@@@@@@@@@@@@@@@@@@@@@@@@@@@@@@@@@TTTTTTTTTTTT..................................TTTTTTT@@@@@@@@@@@@@@@@@@@@@@@@@@@@@@@@@@@@@@@@@@
@@@@@@@@@@@@@@@@@@@@@@@@@@@@@@@@@TTTTTTTTTTTT...............................TTTTTTTTTT@@@@@@@@@@@@@@@@@@@@@@@@@@@@@@@@@@@@@@@@@@
@@@@@@@@@@@@@@@@@@@@@@@@@@@@@@@@@TTTTTTTTTTTT.........TT.......TT.........TTTTTTTTTTTT@@@@@@@@@@@@@@@@@@@@@@@@@@@@@@@@@@@@@@@@@@
@@@@@@@@@@@@@@@@@@@@@@@@@@@@@@@@@TTTTTTTTTTT..........TT.......TT.........TTTTTTTTTTTT@@@@@@@@@@@@@@@@@@@@@@@@@@@@@@@@@@@@@@@@@@
@@@@@@@@@@@@@@@@@@@@@@@@@@@@@@@@@TTTTTTTTTTT..............................TTTTTTTTTTTT@@@@@@@@@@@@@@@@@@@@@@@@@@@@@@@@@@@@@@@@@@
@@@@@@@@@@@@@@@@@@@@@@@@@@@@@@@@@TTTTTTTTTTT..............................TTTTTTTTTTTT@@@@@@@@@@@@@@@@@@@@@@@@@TTTTTTTTTTTTTTTTT
@@@@@@@@@@@@@@@@@@@@@@@@@@@@@@@@@TTTTTTTTTTT..............................TTTTTTTTTTTT@@@@@@@@@@@@@@@@@@@@@@@@@TTTTTTTTTTTTTTTTT
@@@@@@@@@@@@@@@@@@@@@@@@@@@@@@@@@TTTTTTTTTT...............................TTTTTTTTTTTT@@@@@@@@@@@@@@@@@@@@@@@@@TTTTTTTTTTTTTTTTT
@@@@@@@@@@@@@@@@@@@@@@@@@@@@@@@@@TTTTTTTTT..................................TTTTTTTTTT@@@@@@@@@@@@@@@@@@@@@@@@@TTTTTTTTTTTTTTTTT
@@@@@@@@@@@@@@@@@@@@@@@@@@@@@@@@@TTTTTTTTT..................................TTTTTTTTTTTTTTTTTTTTTTTTTTTTTTTTTTTTTTTTTTTTTTTTTTTT
@@@@@@@@@@@@@@@@@@@@@@@@@@@@@@@@@TTTTTTTTT...................................TTTTTTTTTTTTTTTTTTTTTTTTTTTTTTTTTTTTTTTTTTTTTTTTTTT
@@@@@@@@@@@@@@@@@@@@@@@@@@@@@@@@@TTTTTTTTT...................................TTTTTTTTTTTTTTTTTTTTTTTTTTTTTTTTTTTTTTTTTTTTTTTTTTT
@@@@@@@@@@@@@@@@@@@@@@@@@@@@@@@@@@@@@TTTTT....................................TTTTTTTTTTTTTTTTTTTTTTTTTTTTTTTTTTTTTTTTTTTTTTTTTT
@@@@@@@@@@@@@@@@@@@@@@@@@@@@@@@@@@@@@TTTTT.................................TTTTTTTTTTTTTTTTTTTTTTTTTTTT......TTTTTT..TTT.TTTTTTT
@@@@@@@@@@@@@@@@@@@@@@@@@@@@@@@@@@@@@TTTTT..............................TTTTTTTTTTTTTTTTTTTTTTTTTTTTTT.......TTTTTT.......TTTTTT
@@@@@@@@@@@@@@@@@@@@@@@@@@@@@@@@@@@@@TTTTTTT...........................TTTTTTTTTTTTTTTTTTTTTTTTTTTTTTT.T..........T........TTTTT
@@@@@@@@@@@@@@@@@@@@@@@@@@@@@@@@@@@@@TTTTTTT.TTT.......................TTT.TTTTTTTTTTTTTTTTTTTTTTTTTTTTT...........TT......TTTT@
@@@@@@@@@@@@@@@@@@@@@@@@@@@@@@@@@@@@@TTTTTTTTTTT.......................TTT.TTTTTTTTTTTTTTTTTTTTTTTTTT..............TT......TTT@@
@@@@@@@@@@@@@@@@@@@@@@@@@@@@@@@@@@@@@TTTT@TTTTTTT......................TTT.TTTTTTTTTTTTTTTTTTTTTTTTTTT.........TT..TT......TTT@@
@@@@@@@@@@@@@@@@@@@@@@@@@@@@@@@@@@@@@TTTTTTTTTTTTT.....................TTT.TTTTTTTTTTTTTTTTTTTTTTTTTTT.T.....TTTT..TT......TTT@@
@@@@@@@@@@@@@@@@@@@@@@@@@@@@@@@@@@@@@TTTTTTTTTTTTT.....................TT..TTTTTTTTTTTTTTTTTTTTTTTTTT......TTTT....TT......TTT@@
@@@@@@@@@@@@@@@@@@@@@@@@@@@@@@@@@@@@@TTTTTTTTTTTTT.........................TTTTTTTTTTTTTTTTTTTTTTTTT.....TTTT......TT......TTT@@
@@@@@@@@@@@@@@@@@@@@@@@@@@@@@@@@@@@@@TTTTTTTTTTTT..........................TTTTTTTTTTTTTTTTTTTTTTTTT.....T.........TT......TTT@@
@@@@@@@@@@@@@@@@@@@@@@@@@@@@@@@@@@@@@TTTTTTTTTT............................TTTTTTTTTTTTTTTTTTTTTTT......TT....TTT..TT......TTTTT
@@@@@@@@@@@@@@@@@@@@@@@@@@@@@@@@@@@@@TTTTTTTTT.............................TTTTTTTTTTTTTTTTTTTTTTT.......T....TTT......TT..TTTTT
@@@@@@@@@@@@@@@@@@@@@@@@@@@@@@@@@@@@@TTTTTTTT..............................TTTTTTTTTTTTTTTTTTTTTTT............TTT.....TTT..TTTTT
@@@@@@@@@@@@@@@@@@@@@@@@@@@@@@@@@@@@@TTTTTTTTTTT...........................TTTTTTTTTTTTTTTTTTTTTT...T.................TTTTTTTTTT
@@@@@@@@@@@@@@@@@@@@@@@@@@@@@@@@TTTTTTTTTTTTT@@TT.......................TTTTTTTTTTTTTTTTTTTTTTTTT...TT................TT.TTTTTTT
@@@@@@@@@@@@@@@@@@@@@@@@@@@@@@@@TTTTTTTTTTTT@@@@T.......................TTTTTTTTTTTTT@@TTTTTTTTTT.........................TTTTTT
@@@@@@@@@@@@@@@@@@@@@@@@@@@@@@@@TTTTTTTTTTT@@@@@TT......................TTTTTTTTTTTTT@@@@@@TTTTTT.........................TTTTTT
@@@@@@@@@@@@@@@@@@@@@@@@@@@@@@@@TTTTTTTTTTT@@@@@@T.........................T@@@TTTTTTTTTTTTTTTTTTTTT.......................TT.T@
@@@@@@@@@@@@@@@@@@@@@@@@@@@@@@@@TTTTTTTTT@@@@@@@@TT........................T@@@@@@@TT......................................TT.T@
@@@@@@@@@@@@@@@@@@@@@@@@@@@@@@@@TTTTTTTTTT@@@@@@@@TT.......................TTTTTTTTTT.........................................T@
@@@@@@@@@@@@@@@@@@@@@@@@@@@@@@@@TTTTTTTTTT@@@@@@@@@TTT........................................................................T@
@@@@@@@@@@@@@@@@@@@@@@@@@@@@@@@@@@TTTTTTTT@@@@@@@@@@@T........................................................................T@
@@@@@@@@@@@@@@@@@@@@@@@@@@@@@@@@@@TTTTTTTT@@@@@@@@@@@TT.......................................................................T@
@@@@@@@@@@@@@@@@@@@@@@@@@@@@@@@@@@TTTTTTTT@@@@@@@@@@@T........................................................................T@
@@@@@@@@@@@@@@@@@@@@@@@@@@@@@@@@TTTTTTTTTT@@@@@@@@@@TT........................................................................T@
@@@@@@@@@T@@@@@@@@@@@@@@@@@@@@@@TTTTTTTTTT@@@@@@@@@TT.........................................................................T@
@@@@@@@TTTTTTTTTTTTTTTTT@@@@@@@@TTTTTTTTT@@@@@@@@@TT.......................................................................TT.T@
@@@@@@@TTTTTTTTTTTTTTTTT@@@@@@@@TTTTTTTTT@@@@@@@@TT........................................................................TT.T@
@@@@@@TTTTTTTTTTTTTTTTTTTTTTTTTTTTTTTTTTTTT@@@@@TT.........................................................................TTTTT
@@@@@@TTTTTTTTTTTTTTTTTTTTTTTTTTTTTTTTTTTTTTTTTTT..........................................................................TTTTT
@@@@@TTTTTTT@@@@@@@@@T@TTTTTTTTTTTTTTTTTTT......................................................TT.........................TTTTT
@@@@@@TTTTT@@@@@@@@@@T@TTTTTTTTTTTTTTTTTTTT.....................................................TT........TTTT.............TTTTT
@@@@@TTTTT@@@@@@@@@@@@@@@@@@@TT@@@T@TTTT@@TT...................................................TTTTTTTTT..TTTTTTTTT..TTT...TTTTT
@@@@@TTTT@@@@@@@@@@@@@@@@@@@@TT@@@T@@TTTTT@TTTT................................................TTTTTTTTTTTTTTTTTTTTTTTTTTTTTTTTT
@@@@@TTTT@@@@@@@@@@@@@@@@@@@@TT@@@T@@@@@TTTTTTT................................................T@TTTTTTTTTTTTTTTTTTTTTTTTTTTTTTT
@@@@TTTTT@@@@@@@@@@@@@@@@@@@@TT@@@T@@@@@@@@TTTTTT.............................................TT@TTTTTTTTTTTTTTTTTTTTTTTTTTTTTTT
@@@@TTTT@@@@@@@@@@@@@@@@@@@@@@@@@@@@@@@TTTTTTTT...............................................T@@TTTTTTTTTTTTTTTTTTTTTTTTTTTTTTT
@@@@TTTT@@@@@@@@@@@@@@@@@@@@@TT@@@TTTTTTTTTTTTT...............................................T@@TTTTTTTTTTTTTTTTTTTTTTTTTTTTTTT
@@@TTTTT@@@@@@@@@@@@@@@@@@@@@TT@@@TTTTTTTTTTTTT...............................................TT@@@@@@@@@TTTTTTTTTTTTTTTTTTTTTTT
@@@TTTT@@@@@@@@@@@@@@@@@@@@@@TT@@@TTTTTTTTTTTTT......................................TTTTTTTTTTTTTTTTTTTTTTTTTTTTTTTTTTTTTTTTTTT
@@@TTTT@@@@T@@@@@@@@@@@@@@@@@TT@@@TTTTTTTTTTTTT......................................TTTTTTTTTTTTTTTTTTTTTTTTTTTTTTTTTTTTTTTTTTT
@@@TTTT@@@@TTT@@@@@@@@@@@@@@@TT@@@TTTTTTTT@@@@T......................................T..................TTTTTTTTTTTTTTTTTTTTTTTT
@@TTTTT@@@TTTTT@@@@@@@@@@@@@@TT@@@TT@@@@@@@TT@T......................................T..................TTTTTTTTTTTTTTTTTTTTTTTT
@@TTTTTT@TTTTTTTT@@@@@@@@@@@@TT@@@TT@@@@@TTTT@T......................................T................TTTTTTTTTTTTTTTTTTTTTTTTTT
@@TTTTT@@TTTTTTTTTT@@@@@@@@@@@@@@@TTTTTTTTTTTTT......................................T................TTTTTTTTTTTTTTTTTTTTTTTTTT
@@TTTTT@TTTTTTTTTTTT@@@@@@@@@@@@@@TTTTTTTTTTTTT......................................T.......TT......TTTTTTTTTTTTTTTTTTTTTTTTTTT
@TTTTTTTTTTTTTTTTTTTTT@@@@@@@@@@@@TTTTTTTTTTTTT.....................................TT......TTTT.....TTTTTTTTTTTTTTTTTTTTTTTTTTT
@TTTTT@TTTTTTTTTTTTTTTT@@@@@@@@@@@TTTTTTTTTTTTT..................................T..TT.....TTTTTT....TTTT@TTTTTTTTTTTTTTTTTTTTTT
@TTTTTTTTTTTTTTTTTTTTTTTT@@@@@@@@@TTTTTTTTTTTTT.........................TTTTTTTTTTTTTT....TTTTTTTTTTTTTTTTTTTTTTTTTTTTTTTTTTTTTT
@TTTTTTTTTTTTTTTTTTTTTTTTT@@@@@@@@TTTTTTTTTTTTT..........................................TTTTTTTTTTTTTTTTTTTTTTTTTTTTTTTTTTTTT@@
@TTTTTTTTTTTTTTTTTTTTTTTTTTTTTTTTTTTTTTTTTTTTTT...........................................TTTTTTTTTTTTTTTTTTTTTTTTTTT@@@@@@@@@@@
@TTTTTTTTTTTTTTTTTTTTTTTTTTTTTTTTTTTTTTTT@@@@@TTTTTT.......................................TTTTTTTTTTTTTTTTTTTT@@@@@@@@@@@@@@@@@
@TTTTTTTTTTTTTTTTTTTTTTTTTTTTTTTTTTTTTTTTTTTTTTTTTTTTTTT....................................TTTT@@@@@@@@@@@@@@@@@@@@@@@@@@@@@@@@
@TTTTTTTTTTTTTTTTTTTTTTTTTTTTTTTTTTTTTTTTTTTTTTTTTTTTTTT................TTTTTTTTTTTTTT.......TTT@@@@@@@@@@@@@@@@@@@@@@@@@@@@@@@@
@TTTTTTTTTTTTTTTTTTTTTTTTTTTTTTTTTTTTTTTT@TTT@TTTTTT@TTT................TTTTTTTTTTTTTT.......TTT@@@@@@@@@@@@@@@@@@@@@@@@@@@@@@@@
@TTTTTTTTTTTTTTTTTTTTTTTTTTTTTTTTTTTTTTTTTTTTTTTTTTTTTTT............................TT.......TTT@@@@@@@@@@@@@@@@@@@@@@@@@@@@@@@@
TTTTTTTTTTTTTTTTTTTTTTTTTTTTTTTTTTTTTTTTTTTTTTTTTTTTTTTT............................TT.......TTT@@@@@@@@@@@@@@@@@@@@@@@@@@@@@@@@
TTTTTTTTTTTTTTTTTTTTTTTTTTTTTTTTTTTTTTTTTTTTTTTTTTTT@TTT............................TT.......TTT@@@@@@@@@@@@@@@@@@@@@@@@@@@@@@@@
TTTTTTTTTTTTTTTTTTTTTTTTTTTTTTTTTTTTTTTTTTTTTTTTTTTTTTTT............................TT.......TTT@@@@@@@@@@@@@@@@@@@@@@@@@@@@@@@@
TTTTTTTTTTTTTTTTTTTTTTTTTTTTTTTTTTTTTTTTTTTTTTTTTTTTTTTT............................TT.......TTT@@@@@@@@@@@@@@@@@@@@@@@@@@@@@@@@
TTTTTTTTTTTTTTTTTTTTTTTTTTTTTTTTTTTTTTTTTTTTTTTTTTTTTTTT............................TT.......TTT@@@@@@@@@@@@@@@@@@@@@@@@@@@@@@@@
TTTTTTTTTTTTTTTTTTTTTTTTT@TTTTTTTTTTTTTTTTTTTTTTTTTTTTTT..........................TTTT.......TTT@@@@@@@@@@@@@@@@@@@@@@@@@@@@@@@@
TTTTTTTTTTTTTTTTTTTTTTTT@TTTTTTTTTTTTTTTTTTTTTTTTTTTTTTT....................TTTTTTTTTT....TTTTTT@@@@@@@@@@@@@@@@@@@@@@@@@@@@@@@@
TTTTTTTTTTTTTTTTTTTTTTTTT@@@TTTTTT@TT@@TTTTTTTT.TTTTTTT.............................TT....TTTTTT@@@@@@@@@@@@@@@@@@@@@@@@@@@@@@@@
TTTTTTTTTTTTTTTTTTTTTTTT@T@@@TTTTT@TTTTTTTTTTT......................................TT.TTTTTTTTTTTTT@@@@@@@@@@@@@@@@@@@@@@@@@@@@
TTTTTTTTTTTTTTTTTTTTTTT@@@@TTT..TT@TTTTT.TTT.................................TTTTTTTTT.TTTTTTTTTTTTT@@@@@@@@@@@@@@@@@@@@@@@@@@@@
TTTTTTTTTTTTTTTTTTTTTT@@@@@TT...TTT@TTTT.....................................TTTTTTTTT.TTTTTTTTTTTTT@@@@@@@@@@@@@@@@@@@@@@@@@@@@
TTTTTTTTTTTTTTTTTTTTTT@@@@TT...TTTT@TTTT.....................................TTTTTTTTTTTTTTTTTTTTTTT@@@@@@@@@@@@@@@@@@@@@@@@@@@@
TTTTTTTTTTTTTTTTTTTT@@TT@@T.....TT@@@T@T.....................................TTTTTTTTTTTTTTTTTTTTTTT@@@@@@@@@@@@@@@@@@@@@@@@@@@@
TTTTTTTTTTTTTTTTTTT@@@@T@TT.....TTTTTTTTT..................................TTTTTTTTTTTTTTTTTTTTTTTTT@@@@@@@@@@@@@@@@@@@@@@@@@@@@
TTTTTTTTTTTTTTTTTTT@@@@@TT......TT@@@@@TT..................................TTTTTTTTTTTTTTTTTTTTTTTTT@@@@@@@@@@@@@@@@@@@@@@@@@@@@
@TTTTTTTTTTTTTTTTT@@@@TTT........TTTTTTT.....................................TTTTTTTTTTTTTTTTTTTTTTT@@@@@@@@@@@@@@@@@@@@@@@@@@@@
@TTTTTTTTTTTTTTTT@@@@TTT..........................................TTTTTTTTTTTTTTTTTTTTTTTTTTTTTTTTTT@@@@@@@@@@@@@@@@@@@@@@@@@@@@
@TTTTTTTTTTTTTTTT@@@TTT...........................................T@@@@@@TTTTTTTTTTTTTTTTTTTTTTTTTTT@@@@@@@@@@@@@@@@@@@@@@@@@@@@
@TTTTTTTTTTTTTTTT@@TTT............................................T@@@@@@TTTTTTTTTTTTTTTTTTTTTTTTTTT@@@@@@@@@@@@@@@@@@@@@@@@@@@@
@TTTTT@TTTTTTTT@@TTTT.............................................T@@@@@@TTTTTTTTTTTTTTTTTTTTTTTTTTT@@@@@@@@@@@@@@@@@@@@@@@@@@@@
@TTTTT@@@TTTTTTTTTTT...........................................TTTT@@@@@@TTTTTTTTTTTTTTTTTTTTTTTTTTT@@@@@@@@@@@@@@@@@@@@@@@@@@@@
@TTTTT@@@@TTTTTTTTT...........................................TTTTT@@@@@TTTTTTTTTTTTTTTTTTTTTTTTTTTT@@@@@@@@@@@@@@@@@@@@@@@@@@@@
@TTTTT@@@@@@TTTTTTT...........................................TTTTT@@@@TTTTTTTTTTTTTTTTTTTTTTTTTTTTT@@@@@@@@@@@@@@@@@@@@@@@@@@@@
@TTTTT@@@@@@@TTTTTT.............................................TTT@TT@TTTTTTTTTTTTTTTTTTTTTTTTTTTTT@@@@@@@@@@@@@@@@@@@@@@@@@@@@
@TTTTT@@@@@@@TTTTTT..............................................TT@TTTTTTTTTTTTTTTTTTTTTTTTTTTTTTTT@@@@@@@@@@@@@@@@@@@@@@@@@@@@
@TTT@@@@@@@@@TTTTTT.............................................TTT@TTTTTTTTTTTTTTTTTTTTTTTTTTTTTTTT@@@@@@@@@@@@@@@@@@@@@@@@@@@@
@TTT@@@@@@@@@TTTTTT.............................................TTTTTTTTTTTTTTTTTTTTTTTTTTTTTTTTT@@@@@@@@@@@@@@@@@@@@@@@@@@@@@@@
@TTT@@@@@@@@@TTTTTT...........................................TTTTTTTTTTTTT@@TTTTTTTTTTTTTTTTTTT@@@@@@@@@@@@@@@@@@@@@@@@@@@@@@@@
@TTT@@@@@@@@T@@TTTT...........................................TTTTTTTTTTTTT@@TTTTTTTTTTTTTTTTTTT@@@@@@@@@@@@@@@@@@@@@@@@@@@@@@@@
@TTT@@TTTTTTTTTTTTTT..........................................TTTTTTTTTTTTT@@TTTTTTTTTTTTTTTTTTT@@@@@@@@@@@@@@@@@@@@@@@@@@@@@@@@
@TTT@@TTTTTTTTTTTTTTT.........................................TTTTTTTTTTTTT@@TTTTTTTTTTTTTTTTTTT@@@@@@@@@@@@@@@@@@@@@@@@@@@@@@@@
@TTT@@TTTTTTTTTTTTTT..........................................TTTTTTTTTTTTTTTTTTTTTTTTTTTTTTTTTT@@@@@@@@@@@@@@@@@@@@@@@@@@@@@@@@
@TTT@@TTTTTTTTTTTTT...........................................TTTTTTTTTTTTTTTTTTTTTTTTTTTTTTTTTT@@@@@@@@@@@@@@@@@@@@@@@@@@@@@@@@
@TTTTTTTTTTTTTTTTT............................................TTTTTTTTTTTTT@@TTTTTTTTTTTTTTTTTTT@@@@@@@@@@@@@@@@@@@@@@@@@@@@@@@@
@TTT@@TTT....TTTT.............................................TTTTTTTTTTTTT@@@@@@@@@@@@@@@@@@TTT@@@@@@@@@@@@@@@@@@@@@@@@@@@@@@@@
@TTTTTTTT.....TT..............................................TTTTTTTTTTTTT@@@@@@@@@@@@@@@@@@TTT@@@@@@@@@@@@@@@@@@@@@@@@@@@@@@@@
@TTTTTTTT.............TT...............TT.....................TTTTTTTTTTTTT@@@@@@@@@@@@@@@@@@TTT@@@@@@@@@@@@@@@@@@@@@@@@@@@@@@@@
@TTTTTTT..............TT...............TT..................TTTTTTTTTTTTTTTT@TTTTTT@@@@@@@@@@TTTT@@@@@@@@@@@@@@@@@@@@@@@@@@@@@@@@
@TTTTT.....................................................TTTTTTTTTTTTTTTTTTTTTTTTTTTTTTTTTTTTTT@@@@@@@@@@@@@@@@@@@@@@@@@@@@@@@
@TTTTT..............TTTTTTT..........TTTTTTT...............TTTTTTTTTTTTTTTTTTTTTTTTTTTTTTTTTTTTTTT@@@@@@@@@@@@@@@@@@@@@@@@@@@@@@
@TTTTT..............TTTTTTT..........TTTTTTT...............TTTTTTTTTTTTTTTTTTTTTTTTTTTTTTTTTTTTTT@@@@@@@@@@@@@@@@@@@@@@@@@@@@@@@
@TTTTT..............TTTTTTT..........TTTTTTT...............TTTTTTTTTTTTTTTTTTTTTTTTTTTTTTTTTTTTT@@@@@@@@@@@@@@@@@@@@@@@@@@@@@@@@
@TTT................TTTTTTT..........TTTTTTTT..............TTTTTTTTT@@@@@@@@@@@TTTTTTTTTTTTTTTTT@@@@@@@@@@@@@@@@@@@@@@@@@@@@@@@@
@TTT...TT..........TTTTTTTT..........TTTTTTTTT.............TTTTTTTTT@@@@@@@@@@@TTTTTTTTTTTTTTTTT@@@@@@@@@@@@@@@@@@@@@@@@@@@@@@@@
@TTT....TT........TTTTTTTTT..........TTTTTTTTTT.....TTTT...TTTTTTTTT@@@@@@@@@@@TTTTTTTTTTTTTTTTT@@@@@@@@@@@@@@@@@@@@@@@@@@@@@@@@
@TTT.....TT......TTTTTTTTTT..........TTTTTTTTTTT...TTT....TTTTTTTTTT@@@@@@@@@@@TTTTTTTTTTTTTTTTT@@@@@@@@@@@@@@@@@@@@@@@@@@@@@@@@
@TTTT.....TT....TTTTTTTTTTTTTTTTTTTTTTTTTTTTTTTTTTTT......TTTTTTTTTT@@@@@@@@@@@@@@@@@@@@@@@@@@@@@@@@@@@@@@@@@@@@@@@@@@@@@@@@@@@@
@TTTTT.....T...TTTTTTTTTTTTTTTTTTTTTTTTTTTTTTTTTTT........TTTTTTTTTT@@@@@@@@@@@@@@@@@@@@@@@@@@@@@@@@@@@@@@@@@@@@@@@@@@@@@@@@@@@@
@TTTTTT....T..TTTTTTTTTTT@@@@@@@@@@@@@@TTTTT@TTTTTT.....TTTTTTTTTTTT@@@@@@@@@@@@@@@@@@@@@@@@@@@@@@@@@@@@@@@@@@@@@@@@@@@@@@@@@@@@
@TTTTTTT.....TTTTTT@TTTTT@@@@@@@@@@@@@@TTTTT@@TTTTTT..TTTTTTTTTTTTTT@@@@@@@@@@@@@@@@@@@@@@@@@@@@@@@@@@@@@@@@@@@@@@@@@@@@@@@@@@@@
TTTTTTTTT...TTTTTT@@TTTTT@@@@@@@@@@@@@@TTTTT@@@TTTTTTTTTTTTTTTTTTTTT@@@@@@@@@@@@@@@@@@@@@@@@@@@@@@@@@@@@@@@@@@@@@@@@@@@@@@@@@@@@
TTTTTTTTTTTTTTTTTTT@TTTTT@@@@@@@@@@@@@@TTTTT@@TTTTTTTTTTTTTTTTTTTTTT@@@@@@@@@@@@@@@@@@@@@@@@@@@@@@@@@@@@@@@@@@@@@@@@@@@@@@@@@@@@
@TTTTTTTTTTTTTTTTTT@TTTTT@@@@@@@@@@@@@@TTTTT@@TTTTTTTTTTTTTTTTTTTTTT@@@@@@@@@@@@@@@@@@@@@@@@@@@@@@@@@@@@@@@@@@@@@@@@@@@@@@@@@@@@
@TTTTTTTTTTTTTTTTTT@TTTTT@@@@@@@@@@@@@@TTTTT@@TTTTTTTTTTTTTTTTTTTTTT@@@@@@@@@@@@@@@@@@@@@@@@@@@@@@@@@@@@@@@@@@@@@@@@@@@@@@@@@@@@
@TTTTTTTTTTTTTTTTTT@TTTTT@@@@@@@@@@@@@@TTTTT@@TTTTTTTTTTTTTTTTTTTTTT@@@@@@@@@@@@@@@@@@@@@@@@@@@@@@@@@@@@@@@@@@@@@@@@@@@@@@@@@@@@
