type octile
height 50
width 49
map
@@@@@@@@TTTTTTTTTTTTTTTTTTTTTTTTT@@@@@@@@@@@@@@@@
@@@@@@@@TTTTTTTTTTTTTTTTTTTTTTTTT@@@@@@@@@@@@@@@@
@@@@@@@@TTTTTTTT..TTTTTT........T@@@@@@@@@@@@@@@@
@@@@@@@@TTTTTTTT..TTTTT.......TTT@@@@@@@@@@@@@@@@
@@@@@@@@TTT...................TTT@@@@@@@@@@@@@@@@
@@@@@@@@TTT...............TTTTTTT@@@@@@@@@@@@@@@@
@@@@@@@@TTT.........T.....TTTTTTT@@@@@@@@@@@@@@@@
@@@@@@@@TTT.......TTTTT.TTTTTTTTT@@@@@@@@@@@@@@@@
@@@@@@@@TTTT......TTTTTTTTTTTTTTT@@@@@@@@@@@@@@@@
@@@@@@@@TTTT......TTTTTTT@@@@@@@@@@@@@@@@@@@@@@@@
@@@@@@@@TTTT......TTTTTTT@@@@@@@@@@@@@@@@@@@@@@@@
@@@@@@@@TTT............TT@@@@@@@@@@@@@@@@@@@@@@@@
@@@@@@@@TT.............TT@@@@@@@@@@@@@@@@@@@@@@@@
@@@@@@@@TT.............TT@@@@@@@@@@@@@@@@@@@@@@@@
@@@@@@@@TT.......TTTTT.TT@@@@@@@@@@@@@@@@@@@@@@@@
@@@@@@@@TT......TTTTTTTTT@@@@@@@@@@@@@@@@@@@@@@@@
@@@@@@@@TTTT..TTTTTTTTTTT@@@@@@@@@@@@@@@@@@@@@@@@
@@@@@@@@@@TT..T@@@@@@T@@@@@@@@@@@@@@@@@@@@@@@@@@@
TTTTTTTTTTTT..TTTTTTTTTTTTTTTTTTT@@@@@@@@@@@@@@@@
TTTTTT........TTTTTT....TTTTTT.TT@@@@@@@@@@@@@@@@
TTTTTTTTT.....TTTTTT...........TT@@@@@@@@@@@@@@@@
TTTTTTTTT......TTTTTTTT.TTTTTTTTT@@@@@@@@@@@@@@@@
TT@TTTT.........TTTTTTT.TTTTTTTTT@@@@@@@@@@@@@@@@
TT@@TT............TTTTT.TTTTTTTTT@@@@@@@@@@@@@@@@
TTTT..............TT...........TTT@@@@@@@@@@@@@@@
TTTT...........................TTTTTTTTTT@@@@@@@@
TT......................TTT.....TTTTTTTTT@@@@@@@@
TT.....................TTTT...TTTT.TTTTTT@@@@@@@@
.......................TTTT..TTTTT....TTT@@@@@@@@
........................TTT..TTTTTTT..TTT@@@@@@@@
TT......................TT......TTTTT.TTT@@@@@@@@
TT......................TT....TTT@TT....T@@@@@@@@
TT............................TTTTTT....T@@@@@@@@
TT.........................TTTTTTTTT....TTTTTTTTT
TT.TTTT....................TTTTTT.TT..TTTTTTTTTTT
TTTTTTTTT.T.....TT...........TTTT....TTT@@@@@TTTT
TTTTTTTTTTTT....TT............TTT.......TT@@@TTTT
TTTTTTTTTTTT....TTT........TT.TTT......TTT@@@@@TT
@@@@@@@@TTTT..TTTTT........TT.TTT......TTTTT@TTTT
@@@@@@@@TTTT..TTTTT........TT.TTT.......TTTT@TTTT
@@@@@@@TTTT..............TTTTTTTT......TTTT@@TTTT
@@@@@@TTTTTT.............TTTTTTTT......TTT@@@TTTT
@@@@@@@@TTTTT.T...........TTT@TTT.....TT@@@TTTTTT
@@@@@@@@TTTTTTTT........TTTTTTTTT....TTT@@TTTT@@T
@@@@@@@@@TTTTTTTT.......TTTTTTTTT.......TTTTTTTTT
@@@@@@@@@@TTTTTTTT......................TTTTTTTTT
@@@@@@@@@@@TTT@@TT......................T@@@@@@@@
@@@@@@@@@@@@TT@@TTTTTTT...............TTT@@@@@@@@
@@@@@@@@@@@@@@@@TTTTTTTTTTTTTTTTTTTTTTTTT@@@@@@@@
@@@@@@@@@@@@@@@@TTTTTTTTTTTTTTTTTTTTTTTTT@@@@@@@@
