type octile
height 21
width 30
map
@@@@@@@@@@@@@TTTTTT@@@@@@@@@@@
@@@@@@@@@@@@@TTTTTT@@@@@@@@@@@
@@@@@@@@@@@@@TTTTTT@@@@@@@@@@@
@@@@@T@@@@@@@TTT.T@@@@@@@@@@@@
@TTTTTTTTTTTTT...T@@@@@@@@@@@@
@TTTTTTTTTTTT...TT@@@@@@@@@@@@
@TTTTTTT........TT@@@@@@@@@@@@
@TTTTTTT........TT@@@@@@@@@@@@
@TTTTTTTT.......TTTTTTTTTTTTTT
@TTTTTTTT.......TTT.....TT..TT
@TTTTTTTT.......TTT.........TT
@TT.........................TT
@TT.........................TT
@TT.........................TT
@TT.............TTT.........TT
TTTT.....TTTTTTTTTTTTTTT...TTT
TTTTTTTTTTTTTTTTTTTTTTTT...TTT
@TTTTTTT@@@@@@@@@@@@@@@@@@@@@@
@TTTTTTT@@@@@@@@@@@@@@@@@@@@@@
@TTTTTTT@@@@@@@@@@@@@@@@@@@@@@
@TTTTTTT@@@@@@@@@@@@@@@@@@@@@@
