type octile
height 42
width 33
map
@@@@@@@@@@@@@TT....TT@@@@@@@@@@@@
@@@@@@@@@@@@@TT....TT@@@@@@@@@@@@
@@@@@@@@@@@@@TT....TT@@T@@@@@@@@@
@@@@@@@@@@@TTT.....TTTTTTT@@@@@@@
@@@@@@@@@TTTT.......TTTTTT@@@@@@@
@@@@@@TTTTTTT.......TTTTTT@@@@@@@
@@@@@TTT.............TTTTTTT@@@@@
@@@@@T...............TTTTTTTT@@@@
@@@@T.................TTTTTTTTTT@
@@@TT...................TTTTTTTT@
@@@T...........TTTT.......TTTTTT@
@@T.........TT@@@@@@T.....TTTTT@@
@TT........T@@@@@@@@@TT....TTTTT@
@T........T@@@@@@@@@@@@T...TTTTT@
@T.......T@@@@@@@@@@@@@T....TTTTT
@T.......T@@@@@@@@@@@@@@T....TTTT
@T.......@@@@@@@@@@@@@@@T....TTTT
TT......TT@@@@@@@@@@@@@@@.......T
TT.....TTTT@@@@@@@@@@@@@T.......T
TT.....TTTT@@@@@@@@@@@@@T.......T
TT......TT@@@@@@@@@@@@@@T.......T
TT.......T@@@@@@@@@@@@@@T.......T
@TT......T@@@@@@@@@@@@@TTT.....TT
@TT.......@@@@@@@@@@@@@TT..TTTTTT
@TT.......TT@@@@@@@@@@TTT..TTTTT@
@@TT.......TT@@@@@@@TTTTTTTTTTTT@
@@TTTT.......TTTTTTT@TTTTTTTTTT@@
@@@TTT........TTTTTTTTTTTTTTTT@@@
@@@TTTTTT.....TTTTTTTTTTTTTTTT@@@
@@@@TTTTT....TTTTTTTTTTTTTTTT@@@@
@@@@@TTTTT.TTTTTTTTTTTTTTTTT@@@@@
@@@@@@@TTTTTTTTTT@@@TTTTTTTT@@@@@
@@@@@@@@TTT@TTTTTT@@TTTTTT@@@@@@@
@@@@@@@@@TTTTTTTT@TTTTT@@@@@@@@@@
@@@@@@@@@@TTTTTTTTTTTTT@@@@@@@@@@
@@@@@@@@@@@TT@TTTTTTTTT@@@@@@@@@@
@@@@@@@@@@@@TTTTTTTTTTT@@@@@@@@@@
@@@@@@@@@@@@T@TTTTTTTTT@@@@@@@@@@
@@@@@@@@@@@@@@TT@@TTTTT@@@@@@@@@@
@@@@@@@@@@@@@@TTT@TTTTT@@@@@@@@@@
@@@@@@@@@@@@@@TTTTTTTTT@@@@@@@@@@
@@@@@@@@@@@@@@TTTT@TTTT@@@@@@@@@@
