type octile
height 26
width 36
map
TTTTTTTTTTTTTTTTTTTT..TTTTTTTTTTT@@@
TTTTTTTTTTTTTTT............TTTTTT@@@
TTTTTTT...TTTTT............TTTTTT@@@
TTTTTTT...................TTTTTTT@@@
TTTTTTT....................TTTTTT@@@
TTTTTTT........................TT@@@
TTTTTTT.........................T@@@
TTT.............................T@@@
TT.............................TT@@@
TT.............................TT@@@
TT.............................TT@@@
TT.......TTTTTTTTTTT...........TT@@@
TT.......TTTTTTTTTTT...........TT@@@
TT.......TTTTTTTTTTTT..........TT@@@
TTTT..TTTTTTTTTTTTTTT.........TTT@@@
TTTT..TTTTTTTTTTTTTTT.........TTT@@@
TTTT..TTTTTTTTTTTTTTT.........TTT@@@
TT..........TTTTTTTTT.........TTT@@@
TT............TTT@TTT.........TTT@@@
TT............TTT@TTTT........TTT@@@
TTTTTTTTT.....TTT@TTTT.TT.....TTTT@@
TTTTTTTTTTTTTTTTT@TTTTTTT..TTTTTTT@@
TTTTTTTTTTTTTTTTT@@@TTTTTT.TTTTTTT@@
TTTTTTTT@TTTTTTTT@@@@TTTTTTTTTTTTT@T
@@@@@@@@@@@@@@@@@@@@@@T@@@@@@@@@@@@@
@@@@@@@@@@@@@@@@@@@@@@@T@@@@@@T@@@T@
