type octile
height 30
width 38
map
@@@@@@@@@@@@@@@@@@@@@@TTTTTTTT@@@@@@@@
@@@@TTTTTTTTTTTTTTTTTTTTTTTTTT@@@@@@@@
@@@@TTTTT.T...TTTTT.........TT@@@@@@@@
@@@@TTTT......TTTTTT........TT@@@@@@@@
TTTTTT..........TTTT........TT@@@@@@@@
TTTTTT..........TTTT........TT@@@@@@@@
TTTTTT...TT.....TTT.........TT@@@@@@@@
TTTTTT...TT......TT........TTT@@@@@@@@
TT.TT..TTTTTTT...TT........TTT@@@@@@@@
TT....TTTTTTTT..TTTT.......TTTT@@@@@TT
TT.....TTTTT....TTTT.......TTTTTTTTTTT
TT.......TTT....TTTT........TTTT...TTT
TT..........................TTTT...TTT
TT..........................TTTT...TTT
TT......................TT..TTTT...TTT
TT..............TTTTTTT.TTT.TTTT...TTT
TT..............TTTTTTTTTTTTTTTT...TTT
TT..............TTTTTTTTTTTTTTTT...TTT
TT...............TTTTTTTTTTTTTTT...TTT
TT................TTTT....TTTTTT...TTT
..............................TT...TTT
....................................TT
TT..................................TT
TT..................................TT
TT..............TTTTTTTTTTTTTTTTTTTTTT
TT..............TTTTTTTT@@TTTTTTTTTTTT
TT.........T....TT@@@@@@@@@@@@@@@@@@@@
TTTTTTTTTTTTTTTTTT@@@@@@@@@@@@@@@@@@@@
TTTTTTTTTTTTTTTTTT@@@@@@@@@@@@@@@@@@@@
TTTTTTTTTTTTTTTTTT@@@@@@@@@@@@@@@@@@@@
