type octile
height 41
width 41
map
TTTTTTTTTTTTTTTTTTTTTTTTT@@@@@@@@@@@@@@@@
TTTTTTTTTTTTTTTTTTTTTTTTT@@@@@@@@@@@@@@@@
TT..............TTTTTT@TT@@@@@@@@@@@@@@@@
TT....................TTT@@@@@@@@@@@@@@@@
T.....................TTT@@@@@@@@@@@@@@@@
TT....................TTT@@@@@@@@@@@@@@@@
TT....................TTT@@@@@@@@@@@@@@@@
TT.....................TT@@@@@@@@@@@@@@@@
TT.....................TT@@@@@@@@@@@@@@@@
TT.....................TT@@@@@@@@@@@@@@@@
TT.......TTTT..........TT@@@@@@@@@@@@@@@@
TT.......TTTT............@@@@@@@@@@@@@@@@
TT.......TTTT............@@@@@@@@@@@@@@@@
TT.......................@@@@@@@@@@@@@@@@
TT.....................TT@@@@@@@@@@@@@@@@
TTT....................TT@@@@@@@@@@@@@@@@
TTT....................TTTTTTTTTTTTTTTTTT
TT.....................TTTTTTTTTTTTTTTTTT
TT.....................TT............TTTT
TT....................................TTT
TTT....................................TT
TTT....T.............................TTTT
TTTTTTTTT..............TT.........TTTTTTT
TTTTTTTTTTT..TTTTTTTTTTTT.........TTTTTTT
TTTTTTTTTTT..TTTTTTTTTTTTT........TTTTTTT
TTTTTTTTTTT...TTTTTTTTTTTT........TTTTTTT
TTTTTTTTT......TTTTTTTTTTT..........TTTTT
TTTTTTT..........TTTTTTTTT.........TTTTTT
TTTTTTT...............TTTT.........TTTTTT
TTT...................TTTT..........TTTTT
T.T...................TTTT..........TTTTT
T.....................TTTT..........TTTTT
TT....................TTTT............TTT
TTTTTTT...............TTT.............TTT
TTTTTTT...............TTT..............TT
TTTTTTT................................TT
TTTTTTT..........................TT....TT
TTTTTTT.........................TTTTTTTTT
TTTTTTTT........TTTTTTTTT.......TTTTTTTTT
TTTTTTTTTTTTTTTTTTTTTTTTTTTTTTTTTTTTTTTTT
TTTTTTTTTTTTTTTTTTTTTTTTTTTTTTTTTTTTTTTTT
