type octile
height 145
width 168
map
@@@@@@@@@@@@@@@@@@@@@@@@@@@@@@@@@@@@@@@@@@@@@@@@@@@@@@@@@@@@@@@@@@@@@@@@@@@@@@@@@@@@@@@@@@@@@@@@@@@@@@@@@@@@@@@TTT@@@@@@@@@@@@@@@@@@@@@@@@@@@@@@@@@@@@@@@@@@@@@@@@@@@@@@
@@@@@@@@@@@@@@@@@@@@@@@@@@@@@@@@@@@@@@@@@@@@@@@@@@@@@@@@@@@@@@@@@@@@@@@@@@@@@@@@@@@@@@@@@@@@@@@@@@@@@@@@@@@@@TT.....TT@@@@@@@@@@@@@@@@@@@@@@@@@@@@@@@@@@@@@@@@@@@@@@@@@@
@@@@@@@@@@@@@@@@@@@@@@@@@@@@@@@@@@@@@@@@@@@@@@@@@@@@@@@@@@@@@@@@@@@@@@@@@@@@@@@@@@@@@@@@@@@@@@@@@@@@@@@@@@@T...........TT@@@@@@@@@@@@@@@@@@@@@@@@@@@@@@@@@@@@@@@@@@@@@@@
@@@@@@@@@@@@@@@@@@TT@@@@@@@@@@@@@@@@@@@@@@@@@@@@@@@@@@@@@@@@@@@@@@@@@@@@@@@@@@@@@@@@@@@@@@@@@@@@@@@@@@@@@T.................TT@@@@@@@@@@@@@@@@@@@@@@@@@@@@@@@@@@@@@@@@@@@
@@@@@@@@@@@@@@@@@@T...TT@@@@@@@@@@@@@@@@@@@@@@@@@@@@@@@@@@@@@@@@@@@@@@@@@@@@@@@@@@@@@@@@@@@@@@@@@@@@@@TT.....................T@@@@@@@@@@@@@@@@@@@@@@@@@@@@@@@@@@@@@@@@@@
@@@@@@@@@@@@@@@@@@T......TTT@@@@@@@@@@@@@@@@@@@@@@@@@@@@@@@@@@@@@@@@@@@@@@@@@@@@@@@@@@@@@@@@@@@@@@@@TT........................TT@@@@@@@@@@@@@@@@@@@@@@@@@@@@@@@@@@@@@@@@
@@@@@@@@@@@@@@@@@@T..........TT@@@@@@@@@@@@@@@@@@@@@@@@@@@@@@@@@@@@@@@@@@@@@@@@@@@@@@@@@@@@@@@@@@@T.............................T@@@@@@@@@@@@@@@@@@@@@@@@@@@@@@@@@@@@@@@
@@@@@@@@@@@@@@@@@@T..............TT@@@@@@@@@@@@@@@@@@@@@@@@@@@@@@@@@@@@@@@@@@@@@@@@@@@@@@@@@@@@TT................................TTT@@@@@@@@@@@@@@@@@@@@@@@@@@@@@@@@@@@@
@@@@@@@@@@@@@@@@@@T.................TTT@@@@@@@@@@@@@@@@@@@@@@@@@@@@@@@@@@@@@@@@@@@@@@@@@@@@@@TT......................................TTT@@@@@@@@@@@@@@@@@@@@@@@@@@@@@@@@
@@@@@@@@@@@@@@@@@@T.....................TTT@@@@@@@@@@@@@@@@@@@@@@@@@@@@@@@@@@@@@@@@@@@@@@@@T..............................................TT@@@@@@@@@@@@@@@@@@@@@@@@@@@@
@@@@@@@@@@@@@@@@@@@...........................TTTT@@@@@@@@@@@@@@@@@@@@@@@@@@@@@@@@@@@@@@@T....................................................TTT@@@@@@@@@@@@@@@@@@@@@@@
@@@@@@@@@@@@@@@@@@@TTTTTTTTTTT......................TTTT@@@@@@@@@@@@@@@@@@@@@@@@@@@@@@TT..........................................................TTT@@@@@@@@@@@@@@@@@@@
@@@@@@@@@@@@@@@@@@@TTTTTTTTTTT.............................TTTT@@@TTTTTTTTTTTTTTTTTTTT.................................................................@@@@@@@@@@@@@@@@@
@@@@@@@@@@@@@@@@@@@TTTTTTTTTTT.........................................................................................................................T@@@@@@@@@@@@@@@@
@@@@@@@@@@@@@@@@@@@TTTTTTTTTTT.........................................................................................................................T@@@@@@@@@@@@@@@@
@@@@@@@@@@@@@@@@@@@TTTTTTTTTTT..........................................................................................................................T@@@@@@@@@@@@@@@
@@@@@@@@@@@@@@@@@@@TTTTTTTTTTT..........................................................................................................................T@@@@@@@@@@@@@@@
@@@@@@@@@@@@@@@@@@@TTTTTTTTTTT.......TTTTTTTTTTTTTTTTTTTTTTTTTTTTTTTTTTTTTTTTTTT.........................................................................@@@@@@@@@@@@@@@
@@@@@@@@@@@@@@@@@@@TTTTTTTTTTT.......TTTTTTTTTTTTTTTTTTTTTTTTTTTTTTTTTTTTTTTTTTT.........................................................................T@@@@@@@@@@@@@@
@@@@@@@@@@@@@@@@@@@TTTTTTTTTTT.......TTTTTTTTTTTTTTTTTTTTTTTTTTTTTTTTTTTTTTTTTTT.........................................................................T@@@@@@@@@@@@@@
@@@@@@@@@@@@@@@@@TTTTTTTTTTTTT.......TTTTTTTTTTTTTTTTTTTTTTTTTTTTTTTTTTTTTTTTTTT..........................................................................@@@@@@@@@@@@@@
@@@@@@@@@@@@@@TTTTTTTTTTTTTTTT.......TTTTTTTTTTTTTTTTTTTTTTTTTTTTTTTTTTTTTTTTTTT..........................................................................T@@@@@@@@@@@@@
@@@@@@@@@@@TTTTTTTTTTTTTTTTTTT.......TTTTTTTTTTTTTTTTTTTTTTTTTTTTTTTTTTTTTTTTTTT..........................................................................T@@@@@@@@@@@@@
@@@@@@@@TTTTTTTTTTTTTTTTTTTTTT.......TTTTTTTTTTTTTTTTTTTTTTTTTTTTTTTTTTTTTTTTTTT...........................................................................T@@@@@@@@@@@@
@@@@@TTTTTTTTTTTTTTTTTTTTTTTTT.......TTTTTTTTTTTTTTTTTTTTTTTTTTTTTTTTTTTTTTTTTTT...........................................................................T@@@@@@@@@@@@
@@@@@TTTTTTTTTTTTTTTTTTTTTTTTT.......TTTTTTTTTTTTTTTTTTTTTTTTTTTTTTTTTTTTTTTTTTT............................................................................@@@@@@@@@@@@
@@@@@TTTTTTTTTTTTTTTTTTTTTTTTT.......TTTTTTTTTTTTTTTTTTTTTTTTTTTTTTTTTTTTTTTTTTT......................................TTTTT.................................T@@@@@@@@@@@
@@@@TTTTTTTTTTTTTTTTTTTTTTTTTT.......TTTTTTTTTTTTTTTTTTTTTTTTTTTTTTTTTTTTTTTTTTT.....................................TTTTTTT................................T@@@@@@@@@@@
@@@@TTTTTTTTTTTTTTTTTTTTTTTTTT.......TTTTTTTTTTTTTTTTTTTTTTTTTTTTTTTTTTTTTTTTTTT....................................TTTTTTTTT................................@@@@@@@@@@@
@@@@TTTTTTTTTTTTTTTTTTTTTTTTTT.......TTTTTTTTTTTTTTTTTTTTTTTTTTTTTTTTTTTTTTTTTTT....................................TTTTTTTTT................................T@@@@@@@@@@
@@@@TTTTTTTTTTTTTTTTTTTTTTTTTT.......TTTTTTTTTTTTTTTTTTTTTTTTTTTTTTTTTTTTTTTTTTT....................................TTTTTTTTT................................T@@@@@@@@@@
@@@@TTTTTTTTTTTTTTTTTTTTTTTTTT.......TTTTTTTTTTTTTTTTTTTTTTTTTTTTTTTTTTTTTTTTTTT....................................TTTTTTTTT.................................@@@@@@@@@@
@@@@TTTTTTTTTTTTTTTTTTTTTTTTTT......................................................................................TTTTTTTTT.................................T@@@@@@@@@
@@@TTTTTTTTTTTTTTTTTTTTTTTTTTT.......................................................................................TTTTTTT..................................T@@@@@@@@@
@@@TTTTTTTTTTTTTTTTTTTTTTTTTTT...................................TTT..................................................TTTTT....................................@@@@@@@@@
@@@TTTTTTTTTTTTTTTTTTTTTTTTTTT.TT..............................TTTTTTT.........................................................................................T@@@@@@@@
@@@TTTTTTTTTTTTTTTTTTTTTTTTTTTTTTTT...........................TTTTTTTTT........................................................................................T@@@@@@@@
@@@.TTTTTTTTTTTTTTTTTTTTTTTTTTTTTTTT..........................TTTTTTTTT.........................................................................................T@@@@@@@
@@@..TTTTTTTTTTTTTTTTTTTTTTTTTTTTTTT..........................TTTTTTTTT.........................................................................................T@@@@@@@
@@T...TTTTTTTTTTTTTTTTTTTTTTTTTTTTTT..........................TTTTTTTTT..........................................................................................T@@@@@@
@@T...TTTTTTTTTTTTTTTTTTTTTTTTTTTTTT..........................TTTTTTTTT..........................................................................................T@@@@@@
@@T....TTTTTTTTTTTTTTTTTTTTTTTTTTTTT...........................TTTTTTT............................................................................................T@@@@@
@@T....TTTTTTTTTTTTTTTTTTTTTTTTTTTTT............................TTTTT..................................................................................TTTT.......T@@@@@
@@.....TTTTTTTTTTTTTTTTTTTTTTTTTTTT..................................................................................................................TTTTTTT.......T@@@@
@@.....TTTTTTTTTTTTTTTTTTTTTTT.......................................................................................................................TTTTTTTT......T@@@@
@T........TTTTTTTTTTTTTTTTTTTT......................................................................................................................TTTTTTTTT.......T@@@
@T.........TTTTTTTTTTTTTTTTTTT......................................................................................................................TTTTTTTTT.......T@@@
@T.............TTTTTTTTTTTTTTT......................................................................................................................TTTTTTTTT........T@@
@T....................TTTTTTT........................................................................................................................TTTTTTTT........T@@
@..........................................................................................TTTTT.....................................................TTTTTTTT.........@@
@.........................................................................................TTTTTTT.....................................................TTTTT...........T@
@........................................................................................TTTTTTTT......................................................................@
@........................................................................................TTTTTTTTT.....................................................................T
@........................................................................................TTTTTTTTT.....................................................................T
T........................................................................................TTTTTTTTT.....................................................................T
T......................TTTTTT............................................................TTTTTTTT......................................................................T
T.....................TTTTTTTTTTTT........................................................TTTTTTT.........................................TTTTT........................T
T....................TTTTTTTTTTTTTT........................................................TTTTT.........................................TTTTTTT.......................T
@...................TTTTTTTTTTTTTTTT....................................................................................................TTTTTTTTT......................T
@.................TTTTTTTTTTTTTTTTTTT..................................................................................................TTTTTTTTTT......................T
@................TTTTTTTTTTTTTTTTTTTTT.................................................................................................TTTTTTTTTTT.....................T
@T..............TTTTTTTTTTTTTTTTTTTTTTT................................................................................................TTTTTTTTTTT.....................T
@T.............TTTTTTTTTTTTTTTTTTTTTTTT................................................................................................TTTTTTTTTT...............TT.....T
@T............TTTTTTTTTTTTTTTTTTTTTTTTTT................................................................................................TTTTTTTTT............TTTTTTTT..T
@@..........TTTTTTTTTTTTTTTTTTTTTTTTTTTTT...............................................................................................TTTTTTTTT...........TTTTTTTTTT.T
@@.........TTTTTTTTTTTTTTTTTTTTTTTTTTTTTTT......................................................................TTTT.....................TTTTTT.............TTTTTTTTTTTT
@@........TTTTTTTTTTTTTTTTTTTTTTTTTTTTTTTTT..................................................................TTTTTTTTT.....................................TTTTTTTTTTTTT
@@T......TTTTTTTTTTTTTTTTTTTTTTTTTTTTTTTTTTT................................................................TTTTTTTTTTT....................................TTTTTTTTTTTTT
@@T.....TTTTTTTTTTTTTTTTTTTTTTTTTTTTTTTTTTTT...............................................................TTTTTTTTTTTTT...................................TTTTTTTTTTTTT
@@T...TTTTTTTTTTTTTTTTTTTTTTTT..TTTTTTTTTTTTT..............................................................TTTTTTTTTTTTTT..................................TTTTTTTTTTTTT
@@@..TTTTTTTTTTTTTTTTTTTTTTTTTTTTT...TTTTTTTTT.............................................................TTTTTTTTTTTTTT..................................TTTTTTTTTTTTT
@@@.TTTTTTTTTTTTTTTTTTTTTTTTTTTTTTT.......TTTTT...........................................................TTTTTTTTTTTTTTT...................................TTTTTTTTTTTT
@@@TTTTTTTTTTTTTTTTTTTTTTTTTTTTTTTT.........TT............................................................TTTTTTTTTTTTTTT.............TTTTTTTTTTT............TTTTTTTTT.T
@@@TTTTTTTTTTTTTTTTTTTTTTTTTTTTTTTT.TTT....TT.............................................................TTTTTTTTTTTTTTT............TTTTTTTTTTTTTT...........TTTTTTT..T
@@TTTTTTTT..TTTTTTTTTTTTTTTTTTTTTTT.TTTTTTTT..............................................................TTTTTTTTTTTTTTT..........TTTTTTTTTTTTTTTTT............TTT....T
@@TTTTT....TTTTTTTTTTTTTTTTTTTTTTTTTTTTTTT.................................................................TTTTTTTTTTTTTT.........TTTTTTTTTTTTTTTTTTT..................T
@@TT......TTTTTTTTTTTTTTTTTTTTTTTTTTTTTTT..................................................................TTTTTTTTTTTTT.........TTTTTTTTTTTTTTTTTTTTT.................T
@@TT...TTTTTTTTTTTTTTTTTTTTTTTTTTTTTTTTT....................................................................TTTTTTTTTTT..........TTTTTTTTTTTTTTTTTTTTT.................T
@@T..TTTTTTTTTTTTTTTTTTTTTT..TTTT.TTTTT......................................................................TTTTTTTTT..........TTTTTTTTTTTTTTTTTTTTTTTTTTTTT..........@
@@T.TTTTTTTTTTTTTTTTTTTTT...TTT................................................................................TTTTTT...........TTTTTTTTTTTTTTTTTTTTTTTTTTTTT..........@
@@T.TTTTTTTTTTTTTTTTTTT....TT..................................................................................................TTTTTTTTTTTTTTTTTTTTTTTTTTTTTTT........T@
@@TTTTTTTTTTTTTTTTTT......TT....................................................................TTTTT..........................TTTTTTTTTTTTTTTTTTTTTTTTTTTTTTT........T@
@@TTTTTTTTTTTTTTTT......TTT....................................................................TTTTTTT.........................TTTTTTTTTTTTTTTTTTTTTTTTTTTTTTT........T@
@@TTTTTTTTTTTTTT.......TTT....................................................................TTTTTTTTT........................TTTTTTTTTTTTTTTTTTTTTTTTTTTTTTT........@@
@@TTTTTTTTTTT.........TT......................................................................TTTTTTTTT........................TTTTTTTTTTTTTTTTTTTTTTTTTTTTTTT........@@
@@TTTTTTTTT.........TTT.......................................................................TTTTTTTTT........................TTTTTTTTTTTTTTTTTTTTTTTTTTTTTT........T@@
@@TTTTTT...........TTT...................T....................................................TTTTTTTTT........................TTTTTTTTTTTTTTTTTTTTTTTTTTTT..........T@@
@@TTTTTTT.........TTT.........................................................................TTTTTTTTT.........................TTTTTTTTTTTTTTTTTTTTTTT..............T@@
@@TTTTT.TT.......TT............................................................................TTTTTTT..........................TTTTTTTTTTTTTTTTTTTTTTT..............T@@
@@TTTTT..TT....TTT........................T......................................................TTT............................TTTTTTTTTTTTTTTTTTTTTTT..............@@@
@@TTTT....TT..TTT.........................T......................................................................................TTTTTTTTTTTTTTTTTTTTT...............@@@
@@TTT......T.TT..TTTTTTTTTTTTTTT..........T.......................................................................................TTTTTTTTTTTTTTTTTTT...............T@@@
@@TTT......TTT...TTTTT....................TT......................................................................................TTTTTTTTTTTTTTTTTTT...............T@@@
@@TT......................................TT........................................................................................TTTTTTTTTTTTTTT.................@@@@
@@TT.......................................T.....................................................................................TTT.TTTTTTTTTTTTT..................@@@@
@@T........................................T...................................................................................TTTTTT..TTTTTTTTT...................T@@@@
@T.........................................TT.................................................................................TTTTTTTT.............................T@@@@
@T.........................................TT.................................................................................TTTTTTTTT............................@@@@@
@T.........................................TT.................................................................................TTTTTTTTT............................@@@@@
@T......................T..................TTT................................................................................TTTTTTTTT...........................T@@@@@
@@......................T...................TT................................................................................TTTTTTTTT...........................T@@@@@
@@T.....................T...................TT................................................................................TTTTTTTT............................@@@@@@
@@T....................TT...................TT.........TTTTTT..................................................................TTTTTT.............................@@@@@@
@@@T...................TT...................TTT.......TTTTTTTT...................................................................................................T@@@@@@
@@@T...................TTT..................TTT.......TTTTTTTT...................................................................................................T@@@@@@
@@@@..................TTTT..................TTT......TTTTTTTTT...................................................................................................T@@@@@@
@@@@T.................TTT..T................TTTTT....TTTTTTTTT...................................................................................................@@@@@@@
@@@@T.................T...T..T..............TTTTTTT..TTTTTTTTT..................................................................................................T@@@@@@@
@@@@@.....................T...TT............TTTTTTTTT.TTTTTTTT..................................................................................................T@@@@@@@
@@@@@T....................TT....TT.........TTTTTTTTTTTTTTTTTT...................................................................................................T@@@@@@@
@@@@@T....................TTT....TTT.....TTTTTTTTTTTTTTTTTTT....................................................................................................T@@@@@@@
@@@@@@....................TTT......TTT..TTTTTTTTTTTTTTTTTTTT.....................TTTTTTT.....TTTTTT.....T.......................................................T@@@@@@@
@@@@@@....................TTTTT......TTTTTTTTTTTTTTTTTTTTTTTTT.........TTTTTTTTTTTTTTTTTTTTTT.TTTTT.............................................................T@@@@@@@
@@@@@@T...................TTTTTT......TTTTT.................TTTTTTTTTTTTTTTTTTTTTTTTTTTTTTTTTTTTTTTT............................................................T@@@@@@@
@@@@@@T....................TTTTTT.......TTTTTTT...................................................TT............................................................T@@@@@@@
@@@@@@T..................TTTTTTTT.T.......TTTTTTTT..............................................................................................................T@@@@@@@
@@@@@@T...................TTT.TT.TT..TT..T....TTTTTTTT.................TTTTT....................................................................................T@@@@@@@
@@@@@@@....................TTTT..T...T.......TTTT...TTTTT..............TTTTTTTT..................................................................................@@@@@@@
@@@@@@@....................TTT..T...T...T.....TTTTTTTTT..TTTT..........TT.TTTTTTTTT..............................................................................@@@@@@@
@@@@@@@T...................TT..TT..TT..TT.......TTTTTTTTTTTT..........TTTTTTTTTTTTTTTTT..........................................................................@@@@@@@
@@@@@@@T...................TT..T...T..TT..........TTTTTTTTTTTTT.......TTTTTTT.TTTTTTTTT..........................................................................@@@@@@@
@@@@@@@@T...........TT.....T..TT..T...T.............TTTTTTTTTTT.......TTTT.TTTTTTTTTTT...T..TT..T...T............................................................@@@@@@@
@@@@@@@@T............TTTTTTTT.T..TT..TT..............TTTTTTTTTT.......T.TTTTTTTTTTTT..TT..T...T..TT..T..........................................................T@@@@@@@
@@@@@@@@@T............TTTTTTTTTT.T...T..T..............TTTTTTTT......TTTTTTTTTTTT.......T..TT..T...............................................................T@@@@@@@@
@@@@@@@@@@T.............TTTTTTTTTTTTT...T................TTTTTT......TTTTTTTTT.......TT..T...T.................................................................@@@@@@@@@
@@@@@@@@@@@...............TTTTTTTTTTTTTTT.................TTTTT......TTT...............T..TT..................................................................T@@@@@@@@@
@@@@@@@@@@@T...............TTTTTTTTTTTTTTT..................TTT......................T.......................................................................T@@@@@@@@@@
@@@@@@@@@@@@T................TTTTTTTTTTTTT....................T.............................................................................................T@@@@@@@@@@@
@@@@@@@@@@@@@T.................TTTTTTTTTTTTT.........................................TTTTTTTTTTTTTTTT......................................................T@@@@@@@@@@@@
@@@@@@@@@@@@@@...................TTTTTTTTTTTTT.......................................TTTTTTTTTTTTTTTTTTTTTTTTTT...........................................T@@@@@@@@@@@@@
@@@@@@@@@@@@@@T...................TTTTTTTTTTTTT......................................TTTTTTTTTTTTTTTTTTTT...............................................TT@@@@@@@@@@@@@@
@@@@@@@@@@@@@@@T....................TTTTTTTTTTTT.....................................TTTTTTTTTTTTTT....................................................T@@@@@@@@@@@@@@@@
@@@@@@@@@@@@@@@@T.....................TTTTTTTTTTTT...................................TTTTTTT..........................................................T@@@@@@@@@@@@@@@@@
@@@@@@@@@@@@@@@@@T.....................TTTTTTTTTTTTT.................................T..............................................................T@@@@@@@@@@@@@@@@@@@
@@@@@@@@@@@@@@@@@@@TT.....................TTTTTTTTTTT.........................................................................................TTTT@@@@@@@@@@@@@@@@@@@@@@
@@@@@@@@@@@@@@@@@@@@@TT.......................TTTTTTTTT................................................................................TTTT@@@@@@@@@@@@@@@@@@@@@@@@@@@@@
@@@@@@@@@@@@@@@@@@@@@@@@T.........................TTTTTT...................................................................TTTTTTTT@@@@@@@@@@@@@@@@@@@@@@@@@@@@@@@@@@@@@
@@@@@@@@@@@@@@@@@@@@@@@@@@T...........................TTTT...............................................TTTTT@@@@@@@@@@@@@@@@@@@@@@@@@@@@@@@@@@@@@@@@@@@@@@@@@@@@@@@@@@
@@@@@@@@@@@@@@@@@@@@@@@@@@@@@@@@@@@TTTTTTTT..............TTT.........................................TT@@@@@@@@@@@@@@@@@@@@@@@@@@@@@@@@@@@@@@@@@@@@@@@@@@@@@@@@@@@@@@@@@
@@@@@@@@@@@@@@@@@@@@@@@@@@@@@@@@@@@@@@@@@@@@TT...................................................TT@@@@@@@@@@@@@@@@@@@@@@@@@@@@@@@@@@@@@@@@@@@@@@@@@@@@@@@@@@@@@@@@@@@@@
@@@@@@@@@@@@@@@@@@@@@@@@@@@@@@@@@@@@@@@@@@@@@@@@TT...........................................TT@@@@@@@@@@@@@@@@@@@@@@@@@@@@@@@@@@@@@@@@@@@@@@@@@@@@@@@@@@@@@@@@@@@@@@@@@
@@@@@@@@@@@@@@@@@@@@@@@@@@@@@@@@@@@@@@@@@@@@@@@@@@@TT....................................TTT@@@@@@@@@@@@@@@@@@@@@@@@@@@@@@@@@@@@@@@@@@@@@@@@@@@@@@@@@@@@@@@@@@@@@@@@@@@@
@@@@@@@@@@@@@@@@@@@@@@@@@@@@@@@@@@@@@@@@@@@@@@@@@@@@@@@TT............................TTT@@@@@@@@@@@@@@@@@@@@@@@@@@@@@@@@@@@@@@@@@@@@@@@@@@@@@@@@@@@@@@@@@@@@@@@@@@@@@@@@
@@@@@@@@@@@@@@@@@@@@@@@@@@@@@@@@@@@@@@@@@@@@@@@@@@@@@@@@@@TT..............TTTTTTTT@@@@@@@@@@@@@@@@@@@@@@@@@@@@@@@@@@@@@@@@@@@@@@@@@@@@@@@@@@@@@@@@@@@@@@@@@@@@@@@@@@@@@@
@@@@@@@@@@@@@@@@@@@@@@@@@@@@@@@@@@@@@@@@@@@@@@@@@@@@@@@@@@@@@@TTTTTT@@@@@@@@@@@@@@@@@@@@@@@@@@@@@@@@@@@@@@@@@@@@@@@@@@@@@@@@@@@@@@@@@@@@@@@@@@@@@@@@@@@@@@@@@@@@@@@@@@@@
