type octile
height 112
width 114
map
@@@@@@@@@@@@@@@@@@@@@@@@@@@@@@@@@@@@@@@@@@@@@@@@@@@@@@@@@T@@@@@@@@@@@@@@@@@@@@@@@@@@@@@@@@@@@@@@@@@@@@@@@@@@@@@@@@
@@@@@@@@@@@@@@@@@@@@@@@@@@@@@@@@@@@@@@@@@@@@@@@@@@@@@@@@TT@@@@@@@@@@@@@@@@@@@@@@@@@@@@@@@@@@@@@@@@@@@@@@@@@@@@@@@@
@@@@@@@@@@@@@@@@@@@@@@@@@@@@@@@@@@@@@@@@@@@@@@@@@@@@@@@TTTTTTTTTTTTTTTT@@@@@@@@@@@@@@@@@@@@@@@@@@@@@@@@@@@@@@@@@@@
@@@@@@@@@@@@@@@@@@@@@@@@@@@@@@@@@@@@@@@@@@@@@@@@@@@@@@TTTTTTTTTTTTTTTT@T@@@@@@@@@@@@@@@@@@@@@@@@@@@@@@@@@@@@@@@@@@
@@@@@@@@@@@@@@@@@@@@@@@@@@@@@@@@@@@@@@@@@@@@@@@@@@TTTTTTTTTTTTTTTTTTTTTTTTTTTTTTTTT@@@@@@@@@@@@@@@@@@@@@@@@@@@@@@@
@@@@@@@@@@@@@@@@@@@@@@@@@@@@@@@@@@@@@@@@@@@@@@@@@TTTTTTTTTTTTTTTTTTTTTTTTTTTTTTTTTT@@@@@@@@@@@@@@@@@@@@@@@@@@@@@@@
@@@@@@@@@@@@@@@@@@@@@@@@@@@@@@@@@@@@@@@@@@@@TTTTTTTTTTTTTTTTTTTTTTTTTTTTTTTTTTTTTTTTTTT@@@@@@@@@@@@@@@@@@@@@@@@@@@
@@@@@@@@@@@@@@@@@@@@@@@@@@@@@@@@@@@@@@@@@@@@TTTTTTTTTTTTTTTTTTTTTTTTTTTTTTTTTTTTTTTTTTT@@@@@@@@@@@@@@@@@@@@@@@@@@@
@@@@@@@@@@@@@@@@@@@@@@@@@@@@@@@@@@@@@@TTTTTTTTTTTTTTTTTTTTTTTTTTTTTTTTTTTTTTTTTTTTTTTTTTTT@@@@@@@@@@@@@@@@@@@@@@@@
@@@@@@@@@@@@@@@@@@@@@@@@@@@@@@@@@@@@@@TTTTTTTTTTTTTTTTTTTTTTTTTTTTTTTTTTTTTTTTTTTTTTTTTTTT@@@@@@@@@@@@@@@@@@@@@@@@
@@@@@@@@@@@@@@@@@@@@@@@@@@@@@@@TTTTTTTTTTTTTTTTTTTTTTTTTTTTTTTTTTTTTTTTTTTTTTTTTTTTTTTTTTTTT@@@@@@@@@@@@@@@@@@@@@@
@@@@@@@@@@@@@@@@@@@@@@@@@@@@@@TTTTTTTTTTTTTTTTTTTTTTTTTTTTTTTTTTTTTTTTTTTTTTTTTTTTTTTTTTTTTT@@@@@@@@@@@@@@@@@@@@@@
@@@@@@@@@@@@@@@@@@@@@TTTTTTTTTTTTTTTTTTTTTTTTTTTTTTTTTTTTTTTTTT@@TTTTTTTTTTTTTTTTTTTTTTTTTTT@@@@@@@@@@@@@@@@@@@@@@
@@@@@@@@@@@@@@@@@@@@TTTTTTTTTTTTTTTTTTTTTTTTTTTTTTTTTTTTTTTT@@@@@@TTTTTTTTTTTTTTTTTTTTTTTTTT@@@@@@@@@@@@@@@@@@@@@@
@@@@@@@@@@@@@@@TTTTTTTTTTTTTTTTTTTTTTTTTTTTTTTTTTTTTTTTTTTTT@@@@@@TTTTTTTTTTTTTTTTTTTTTTTTTTT@@@@@@@@@@@@@@@@@@@@@
@@@@@@@@@@@@@@TTTTTTTTTTTTTTTTTTTTTTTTTTTTTTTTTTTTTTTTTTTTT@@@@@@@@@TTTTTTTTTTTTTTTTTTTTTTTTTT@@@@@@@@@@@@@@@@@@@@
@@@@@@@@@@@@@TTTTTTTTTTTTTTTTTTTTTTTTTTTTTTTTTTTTTTTTTTTTTT@@@@@@@@@TTTTTTTTTTTTTTTTTTTTTTTTTTT@@@@@@@@@@@@@@@@@@@
@@@@@@@@@@@@@TTTTTTTTTTTTTTTTTTTTTTTTTTTTTTTTTTTTTTTTTTTTTT@@TTTT@TT@T@TTTTTTTTTTTTTTTTTTTTTTTTT@@@@@@@@@@@@@@@@@@
@@@@@@@@@@@@TTTTTTTTTTTTTTTTTTTTTTTTTTTTTTTTTTTTTTTTTTTTTT@@@TTTTTTT@@@@TTTTTTTTTTTTTTTTTTTTTTTTTT@@@@@@@@@@@@@@@@
@@@@@@@@@@@@TTTTTTTTTTTTTTTTTTTTTTTTTTTTTTTTTTTTTTTTTTTTTT@@@TTTTTTT@@@@@@@TTTTTTTTTTTTTTTTTTTTTTT@@@@@@@@@@@@@@@@
@@@@@@@@@@@@TTTTTTTTTTTTTTTTTTTTTTTTTTTTTTTTTTTTTTTTTTTTTT@@@TTTTTT@@@@T@@@TTTTTTTTTTTTTTTTT@TTTTTTTTT@@@@@@@@@@@@
@@@@@@@@@@@@TTTTTTTTTTTTTTTTTTTTTTTTTTTTTTTTTTTTTTTTTTTTT@@@@TTTTT@@TTTTTTTTTTTTTTTTTTTTTTTT@TTTTTTT@@@T@@@@@@@@@@
@@@@@@@@@@@TTTTTTTTTTTTTTTTTTTTTTTTTTTTTTTTTTTTTTTTTTTTTT@@@@@TTTT@TTTTTTTTTTTTTTTTTTTTTTTTTTTTTTTTTTTTT@@@@@@@@@@
@@@@@@@@@@@TTTTTTTTTTTTTTTTTTTTTTTTTTTTTTTTTTTTTTTTTTTTTT@@@@@TTTTTTTTTTTTTTTTTTTTTTTTTTTTTTTTTTTTTTTTTTTT@@@@@@@@
@@@@@@@@@@TTTTTTTTTTTTTTTTTTTTTTTTTTTTTTTTTTTTTTTTTTTTTT@@TTTTTTT@TTTTTT@@@@@TTTTTTTTTTTTT@TTTTTTTTTTTTTTT@@@@@@@@
@@@@@@@@@@TTTTTTTTTTTTTTTTTTTTTTTTTTTTTTTTTTTTTTTT@TTTTTTTTTTTTTTT@TTTT@@@@@@@@TTTTTTTTTTTTTTTTTTTTTTTTTTT@@@@@@@@
@@@@@@@@@@TTTTTTTTTTTTTTTTTTTTTTTTTTTTTTTTTTTTTTTT@@@TT@@TTTTTT@TTTTTTT@@@@TTT@TT@@TTTTTTTTTTTTTTTTTTTTTTTTT@@@@@@
@@@@@@@@@@TTTTTTTTTTTTTTTTTTTTTTTTTTTTTTTTTTTTTTTT@@TTTT@@TTTTTTTTTTTTTT@TTTTTT@@@@TTTTTTTTTTTTTTTTTTTTTTTTT@@@@@@
@@@@@@@@@@TTTTTTTTTTTTTTTTTTTTTTTTTTTTTTTTTTTTTTTTTTTTTT@@@TT@TTT@@TTTTTTTTTTTTT@@@TTTTT@@TTTTTTTTTTTTTTTTTT@@@@@@
@@@@@@@@@@TTTTTTTTTTTTTTTTTTTTTTTTTTTTTTTTTTTTTTTTTTTT@@T@@@@@@@T@@TTTTTTTTTTTTT@@@TTT@@@@@TTTTTTTTTTTTTTTTT@@@@@@
@@@@@@@@@@TTTTTTTTTTTTTTTTTTTTTTTTTTTTTTTTTTTTTTTTTTTT@@@T@@@@@@T@TTTTTTTTTTTTTT@@@@@@@@@TTTTTTTTTTTTTTTTTTT@@@@@@
@@@@@@@@@@TTTTTTTTTTTTTTTTTTTTTTTTTTTTTTTTTTTTTTTTTTTT@@@T@@@T@@TTTTTTTTTTTTTTTT@@@@@@@@TTTTTTTTTTTTTTTTTTTT@@@@@@
@@@@@@@@@@TTTTTTTTTTTTTTTTTTTTTTTTTTTTTTTTTTTTTTTTTTTTT@@@TTTT@@@@@T@TTTTTTTTTTT@@@T@@@TTTTTTTTTTTTTTTTTTTTTTT@@@@
@@@@@@@@@@TTTTTTTTTTTTTTTTTTTTTTTTTTTTTTTTTTTTTTTTTTTTTT@TT..TTTTTTT@TTTTTTTTTT@@@@T@TTTTTTTTTTTTTTTTTTTTTTTT@@@@@
@@@@@@@@@@TTTTTTTTTTTTTTTTTTTTTTTTTTTTTTTTTTTTTTTTTT@T@@TTT....T...TTTTTTTT@@@T@@TTTTTTTTTTTTTTTTTTTTTTTTTTTTT@@@@
@@@@@@@@@@TTTTTTTTTTTTTTTTTTTTTTTTTTTTTTTTTTTTTTT@@@@@TTT@T........TTTTTTTTTTTT@T@TTTTTTTTTTTTTTTTTTTTTTTTTTTT@@@@
@@@@@@@@@@@@TTTTTTTTTTTTTTTTTTTTTTTTTTTTTTTTTTTTT@@@T@@TT@T.........TTTTT.....T@@@@TTTTTTTTT@TTTTTTTTTTTTTTTTT@@@@
@@@@@@@@@@@@TTTTTTTTTTTTTTTTTTTTTTTTTTTTTTTTTTTT@@@@@T@TTTT.........TTTT......T@@@@TT@@TT@TT@@TTTTTTTTTTTTTTTT@@@@
@@@@@@@@@@@@TTTTTTTTTTTTTTTTTTTTTTTTTTTTTTTTTTTT@@@@@@@TT............T........T@@@@@T@@@@@TTTTTTTTTTTTTTTTTTTT@@@@
@@@@@@@@@@@@TTTTTTTTTTTTTTTTTTTTTTTTTTTTTTTTTTT@@@@@@@TT......................T@TT@@@@@T@@@TTTTTTTTTTTTTTTTTTT@@@@
@@@@@@@@@@@@TTTTTTTTTTTTTTTTTTTTTTTTTTTTTTTTTTT@@@@@@T........................T@TTT@@@@T@@@TTTTTTTTTTTTTTTTTTT@@@@
@@@@@@@@@@@@TTTTTTTTTTTTTTTTTTTTTTTTTTTTTTTTTT@@@T@@TT......TT................T@@TTT@@@T@@@TTTTTTTTTTTTTTTTTTT@@@@
@@@@@@@@@@@@TTTTTTTTTTTTTTTTTTTTTTTTTTTTTTTTTT@@@T@@T......TTT................T@@@@T@@@@@@TTTTT@@TTTTTTTTTTTTT@T@@
@@@@@@@@@@@@TTTTTTTTTTTTTTTTTTTTTTTTTTTTTTTTTTT@TT@TT......TTT................TT@@@TT@@@T@TTTTT@@@@TTTTTTTTTTTTT@@
@@@@@@@@@@@@TTTTTTTTTTTTTTTTTTTTTTTTTTTTTTTT@@TT@TTT...........................T@@@TT@@TTTT@TTTTT@@@@@TTTTTTTTTT@@
@@@@@@@@@@@@TTTTTTTTTTTTTTTTTTTTTTTTTTTTTT@TTTT@TTT............................T@@TTT@@TTTT@@@@@@TT@@@@TTTTTTTTT@@
@@@@@@@@@@@@TTTTTTTTTTTTTTTTTTTTTTTTTTTTT@@T..TTTT.............................TT@TT@@@@TTT@@@@@@@@@@@@@TTTTTTTT@@
@@@@@@@@@@@TTTTTTTTTTTTTTTTTTTTTTTTTTTTTTTT....TT........TTTTTT.................TTT@@@@@@TT@@@@@@@@@@@@TTTTTTTTT@@
@@@@@@@@@@TTTTTTTTTTTTTTTTTTTTTTTTTTTTTTTTT..............TTTTTT.................TTTTTT@@@TT@@@T@@@@@@@@TTTTTTTTT@@
@@@@@@@@@@TTTTTTTTTTTTTTTTTTTTTTTTTTT@@@TTT..................TT..................TTT@TT@@TT@@@@@@@@@@@@TTTTTTTTT@@
@@@@@@@@@@TTTTTTTTTTTTTTTTTTTTTTTTTTT@@@@@TT......................................TT@@@@@TTTT@@T@@@@@@@TTTTTTTTT@@
@@@@@@@@@@TTTTTTTTTTTTTTTTTTTTTTTTTTTT@@@@TT.......................................TT@@@@TTTTTT@@@@@@@@TTTTTTTTT@@
@@@@@@@@@@TTTTTTTTTTTTTTTTTTTTTTTTTTTT@TT@@TT.......................................TT@@@TTTT@@@@@@@@@@@TTTTTTTT@@
@@@@@@@@@@TTTTTTTTTTTTTTTTTTTTTTTTTTTTTTT@@@TTT......................................TTT@TTTTT@@@@@@@@@@@TTTTTTT@@
@@@@@@@@@@TTTTTTTTTTTTTTTTTTTTTTTTTT@@@@@@@@T@TT..................................TT...TTTTTTTTTTT@@@@@@TTTTTTTT@@
@@@@@@@@@@TTTTTTTTTTTTTTTTTTTTTTTTT@@@@@@@@@T@@TTT......................................TTTTTTTTTT@@@@@TTTTTTTTT@@
@@@@@@@@@@TTTTTTTTTTTTTTTTTTTTTTTTT@@@@@@@@T@@@@@TT........................................TTTTT@@@@@@TTTTTTTTTT@@
@@@@@@@@@@TTTTTTTTTTTTTTTTTTTTTTTT@@@@@@T@@@@@@@@@T........................................T@TTT@@@TTTTTTTTTTTTT@@
@@@@@@@@TTTTTTTTTTTTTTTTTTTTTTTTTT@@@@@@TTT@@@@@@TT........................................TT@@@@TTTTTTTTTTTTTTT@@
@@@@@@@@TTTTTTTTTTTTTTTTTTTTTTTTT@@@@@@@@TTT@@@@TT..........................................T@@@TTTTTTTTTTTTTTTT@@
@@@@@@TTTTTTTTTTTTTTTTTTTTTTTTTTT@@@@@@@@TTTT@@TTT..........................................T@@@TTTTTTTTTTTTTTTT@@
@@@@@@TTTTTTTTTTTTTTTTTTTTTTTTTT@@@@@@@@TTTTT@T@TTT.........................................TT@@TTTTTTTTTTTTTTTT@@
@@@@TTTTTTTTTTTTTTTTTTTTTTTTTTTT@@@@@@TTTTTTT@@@TTTT.........................................T@@TTTTTTTTTTTTTTTTT@
@@@TTTTTTTTTTTTTTTTTTTTTTTTTTTTTTT@@@@TTTTTTTTT@TTTT.........................................T@@TTTTTTTTTTTTTTTTT@
@@TTTTTTTTTTTTTTTTTTTTTTTTTTTTTTTTT@@@TTTTTTTTTT@TTT........................................TT@@TTTTTTT@@TTTTTTTT@
@@TTTTTTTTTTTTTTTTTTTTTTTTTTTTTTTTTT@@TTTTTT@@TTTTT........................................TT@@@@TTTTTT@@@@@@@@@T@
@TTTTTTTTTTTTTTTTTTTTTTTTTTTTTTTTTTT@TTTTTTT@@TTT@T........................................T@TTT@TTTTT@@@@@@@@@TT@
@TTTTTTTTTTTTTTTTTTTTTTTTTTTTTTTTTTT@TTTTTTT@@TTT@T........................................T@TTTT@@@@@@@@@@@@TTT@@
TTTTTTTTTTTTTTTTTTTTTTTTTTTTTTTTTTTT@@TTTTT@@TTT@@T........................................T@@TTTT@@@@@@@@@@TTTT@@
@TTTTTTTTTTTTTTTTTTTTTTTTTTTTTTTTTTT@@TTTTTTTTTTT@T.........TTT............................TT@@TTT@@@@@@@@@@@T@T@@
@TTTTTTTTTTTTTTTTTTTTTTTTTTTTTTTTTTT@@TTTTTT@TTT@@T.........TTT.............................TT@TTT@@@@@@@TTTTTTT@@
@TTTTTTTTTTTTTTTTTTTTTTTTTTTTTTTTTT@@@TTTTTTTT@T@@T.........TT...............................TT@@@@@@@TT@@@@@TTT@@
@@TTTTTTTTTTTTTTTTTTTTTTTTTTTTTTTT@@@TTTTTTTTTTTT@T...........................................T@@@@TTTTT@@@TTTTT@@
@@TTTTTTTTTTTTTTTTTTTTTTTTTTTTTT@@@@TTTTTTTTTTTTT@T...........................................TT@@TTTTTT@@@@@@TT@@
@@TTTTTTTTTTTTTTTTTTTTTTTTTTT@@@@@@@TTTTTTTTTTTTT@T............................................TTTTTTTT@@@@@@@@T@@
@@TTTTTTTTTTTTTTTTTTTTTTTTTTT@@@@@@@@TTTTTT@@TTT@TT.............................................TTTTTTT@@@@@@@@T@@
@TTTTTTTTTTTTTTTTTTTTTTTTTTT@@@@@@@@@TTTTT@@@@@@@TT..............................................TTTTTT@@@@@@@@T@@
@TTTTTTTTTTTTTTTTTTTTTTTTTTTT@@@@@@@@@TTT@@@@TTTTTTT........T.....................................TTTT@@@@@@@@@T@@
@@TTTTTTTTTTTTTTTTTTTTTTTTTTT@@@@@@@@@@@@@@@TTTTTTTTT.......T.....................................TTTT@@@@@@@@TTT@
@@TTTTTTTTTTTTTTTTTTTTTTTTTTT@@@@@@@@@@@@@@TTTTTTTTTTT.....TTTT..TTT...............................TTTT@@@TT@@@TTT
@@TTTTTTTTTTT@@@@@@TTTTTTTTTT@@@@@@@@@@@@@@TTTTTTTTTTT....TTTTTTTTTTT..............................T@@@@@@TT@@@TTT
@@TTTTTTTTTT@@@@@@@@TTTTTTTTT@@@@@@@@@@@@@TTTTTTTTTTTTT..TT@TTTTTTTTT..............................TT@@@@@TTTTTTTT
@@@@TTTTTTT@@@@@@@@@@TTTTTTT@@@@@@@@@TTTT@TTTTTTTTTTTTTTTTT@@@T@T@@@@T..............................T@TTTTTTTTTTTT
@@@@TTTTTT@@@@@@@@@@@@@@@@@@T@@@TT@@@TTTTTTTTTTTTTTTTTTT@TT@@T@@T@@@@TTT.....T......................TTTTTTTTTTTTTT
@@@@TTTTTTT@@@@@@@@@@@T@@@TTTTTTTTT@@TTTTTTTTTTTTTTTTTT@T@@@TT@@@@@@@@@TT....T.......................T@TTTTTTTTTTT
@@@@TTTTTTT@@@@@@@T@TTTTTTTTTTTTTTTT@TTTTTTTTTTTTTTTTTT@@@@@@@@@@@@TT@@@TTT..........................TTTTTTTTTTTTT
@@@@@@TTTTTTTT@@@TTTTTTTTTTTTTTTTTTTTTTTTTTTTTTTTTTTTTT@@@@@@@@@@@@@T@@@@@TTT........................TTTTTTTTTTTTT
@@@@@@TTTTTTTTTTTTTTTTTTTTTTTTTTTTTTTTTTTTTTTTTTTTTTTTTT@@@@@@@@@@@TTT@T@@@@TTTT....................TTTTTTTTTTTTTT
@@@@@@@@@@TT@TTT@@TTTTTTTTTTTTTTTTTTTTTTTTTTTTTTTTTTTTTTTTT@@@@@@@@TTTTTTT@@@@@TTT......TTTT........TTTTTTTTTTTTTT
@@@@@@@@@@@TTTTT@@@TTTTTTTTTTTTTTTTTTTTTTTTTTTTTTTTTTTTTTTT@@@@@@@@TTT@TTT@@@@@@@TTTTTTTT@@TT.......TTTTTTTTTTTTTT
@@@@@@@@@@@@@@@@@@@@@@@@TTTTTTTTTTTTTTTTTTTTTTTTTTTTTTTTTTTT@@@@@@@@@@@TTTT@@@@@@@@TTTTTTT@@TT......TTTTTTTTTTTTTT
@@@@@@@@@@@@@@@@@@@@@@@@@TTTTTTTTTTTTTTTTTTTTTTTTTTTTTTTTTTT@T@@@@@@@@@@@@T@@@TTTTT@@@@@TT@@@TT......TTTTTTTTTTTTT
@@@@@@@@@@@@@@@@@@@@@@@@@@@@TTTTTTTTTTTTTTTTTTTTTTTTTTTTTTTT@@@@@@@@@@@@@@@TTTTTTT@@T@@@TT@@@@TTT....TTTTTTTTTTTTT
@@@@@@@@@@@@@@@@@@@@@@@@@@@@TTTTTTTTTTTTTTTTTTTTTTTTTTTTTTTT@@@@@@@@@@@@@@@@@TTTTT@@@T@@TTT@TTTTTTT.TT@TTTTTTTTTTT
@@@@@@@@@@@@@@@@@@@@@@@@@@@@@@@@TTTTTTTTTTTTTTTTTTTTTTTTTTTTT@@@@@@@@@@@@@@@@TTTT@@@TTT@TTTTTTTTTTTTT@@@@@@TTTTTTT
@@@@@@@@@@@@@@@@@@@@@@@@@@@@@@@@@TTTTTTTTTTTTTTTTTTTTTTTTTTTTT@@@@@@@@@@@@@@@@@@@@@@@TT@@@@@TTTTTTTT@@@@@@@TTTTTTT
@@@@@@@@@@@@@@@@@@@@@@@@@@@@@@@@@@@@@@TTTTTTTTTTTTTTTTTTTTTTTTT@@@@@@@@@@@@@@@@@@@@@@@@@@@@@TTTTTTTT@@@@@@TTTTTTTT
@@@@@@@@@@@@@@@@@@@@@@@@@@@@@@@@@@@@@@TTTTTTTTTTTTTTTTTTTTTTTTT@@@@@@@@@@@@@@@@@@@@@@@@@@@@@TTTTTTTT@@@@@TTTTTTTTT
@@@@@@@@@@@@@@@@@@@@@@@@@@@@@@@@@@@@@@@@TTTTTTTTTTTTTTTTTTTTTTTT@@@@@@@@@@@@@@@@@@@@@@@@@@@@TTTTTTTT@@@@@TTTTTTT@T
@@@@@@@@@@@@@@@@@@@@@@@@@@@@@@@@@@@@@@@@TTTTTTTTTTTTTTTTTTTTTTTT@@@@@@@@@@@@@@@@@@@@@@@@@@@@TTTTTTTT@@@@@TTTTTTTTT
@@@@@@@@@@@@@@@@@@@@@@@@@@@@@@@@@@@@@@@@@@@@TTTTTTTTTTTTTTTTTTTTT@@T@@@@@@@@@@@@@@@@@@@@@@@@TTTTTTT@@@@@TTTTTTTT@@
@@@@@@@@@@@@@@@@@@@@@@@@@@@@@@@@@@@@@@@@@@@TTTTTTTTTTTTTTTTTTTTTTTTTTT@@@@@@@@@@@@@@@@@@@@@T@TTTT@@@@@@TTTTTTTTT@@
@@@@@@@@@@@@@@@@@@@@@@@@@@@@@@@@@@@@@@@@@@@@@@@@@@TTTTTTTTTTTTTTTTTTTTTTTT@@@TTTTTTTTTTTTTTT@@@@@@@@TTTTTTTTTTT@@@
@@@@@@@@@@@@@@@@@@@@@@@@@@@@@@@@@@@@@@@@@@@@@@@@@@TTTTTTTTTTTTTTTTTTTTTTTTTTTTTTTTTTTTTTTTTTTT@@TTTTTTTTTTTTTT@@@@
@@@@@@@@@@@@@@@@@@@@@@@@@@@@@@@@@@@@@@@@@@@@@@@@@@@@@@TTTTTTTTTTTTTTTTTTTTTTTTTTTTTTTTTTTTTTTTTTTTTTTTTTTTTT@@@@@@
@@@@@@@@@@@@@@@@@@@@@@@@@@@@@@@@@@@@@@@@@@@@@@@@@@@@@@TTTTTTTTTTTTTTTTTTTTTTTTTTTTTTTTTTTTTTTTTTTTTTTTTTTTTT@@@@@@
@@@@@@@@@@@@@@@@@@@@@@@@@@@@@@@@@@@@@@@@@@@@@@@@@@@@@@@@TTTTTTTTTTTTTTTTTTTTTTTTTTTTTTTTTTTTTTTTTTTTTT@@@@@@@@@@@@
@@@@@@@@@@@@@@@@@@@@@@@@@@@@@@@@@@@@@@@@@@@@@@@@@@@@@@@@TTTTTTTTTTTTTTTTTTTTTTTTTTTTTTTTTTTTTTTTTTTTTT@@@@@@@@@@@@
@@@@@@@@@@@@@@@@@@@@@@@@@@@@@@@@@@@@@@@@@@@@@@@@@@@@@@@@@@TTTTTTTTTTTTTTTTTTTTTTTTTTTTTTTTTTTTTTTTTT@@@@@@@@@@@@@@
@@@@@@@@@@@@@@@@@@@@@@@@@@@@@@@@@@@@@@@@@@@@@@@@@@@@@@@@@@@TTTTTTTTTTTTTTTTTTTTTTTTTTTTTTTTTTTTTTTTT@@@@@@@@@@@@@@
@@@@@@@@@@@@@@@@@@@@@@@@@@@@@@@@@@@@@@@@@@@@@@@@@@@@@@@@@@@@@@@@@@TTTTTTTT@@@@@@@@@@TTTTTTTTTTTTTT@@@@@@@@@@@@@@@@
@@@@@@@@@@@@@@@@@@@@@@@@@@@@@@@@@@@@@@@@@@@@@@@@@@@@@@@@@@@@@@@@@@TTTTTTTT@@@@@@@@@@@TTTTTTTTTTTTT@@@@@@@@@@@@@@@@
