type octile
height 28
width 44
map
@@TTTTTTTTTTTTTTTTTTTTTTTTTTTTTTTTTTTTTTTT@@
@TTTTTTTTTTTTTTTTTTTTTTTTTTTTTTTTTTTTTTTTTTT
@@@TTTTTTTT.........TTTTTTT........TTTTTTTTT
@@@TTTTT.............TTTTT................TT
@@@..........TT.......TT..................TT
@@@.........TTTT.........................TTT
@@@T........TTTTTT......................TTTT
@@TT........TTTTT.......................TTTT
@@TT.........TT...................TTTT..TTTT
@@TT.................TT...........TT@@@@@@TT
@@TT.................TTTT.....TT..TT@@@@@@@@
@@TT.....TTTTTTT....TTTTT...TTTTTTTT@@@@@@@@
@@TTTT...TTTTTTT.....TTTT...TTTTT.TT@@@@@@@@
@@TTTT................TT....TTTT..TT@@@@@@@@
@@TTTTTTTTTTTTTTT.................TT@@@@@@@@
@@@TTTTTTTTTTTTTT.................TT@@@@@@@@
@@@TTTTTTTTTTTTTT..TTTT.....TTT...TT@@@@@@@@
@@TTT..TTTTTTTTTTTTTTTT.....TTT...TT@@@@@@@@
@@TT.......TTTTTTTTTTTT.....TT..TTTT@@@@@@@@
@@TT.......TTTTTTTT.............TTTT@@@@@@@@
@@TT.......TTTTTTT..............TTTT@@@@@@@@
@@TT....................TT......TTTT@@@@@@@@
@@TTTTT..............TTTTTTT....TTTT@@@@@@@@
@@TTTTTTTT.T......TT.TTTTTTT.....TTT@@@@@@@@
T@TTTTTTTTTTTTTTTTTTTTTTTTTTTTTTTTTT@@@@@@@@
@@TTTTTTTTT@@@@@@TTTTTTTTT@@@@@@@@@@@@@@@@@@
T@@@@T@@@@@@@@@@@@@@@@@@@@@@@@@@@@@@@@@@@@@@
@T@@@@@@@@@@@@@@@@@@@@@@@@@@@@@@@@@@@@@@@@@@
