type octile
height 137
width 79
map
@@@@@@@@@@@@@@@@@@@@@@@@@@@@@@@@@.............@@@@@@@@@@@@@@@@@@@@@@@@@@@@@@@@@
@@@@@@@@@@@@@@@@@@@@@@@@@@@@@@@TT.............TT@@@@@@@@@@@@@@@@@@@@@@@@@@@@@@@
@@@@@@@@@@@@@@@@@@@@@@@@@@@@TTTTT.............TTTTT@@@@@@@@@@@@@@@@@@@@@@@@@@@@
@@@@@@@@@@@@@@@@@@@@@@@@@@@@T.TT...............T..T@@@@@@@@@@@@@@@@@@@@@@@@@@@@
@@@@@@@@@@@@@@@@@@@@@@@@@@@@T.....................T@@@@@@@@@@@@@@@@@@@@@@@@@@@@
@@@@@@@@@@@@@@@@@@@@@@@@@@@TT.....................TT@@@@@@@@@@@@@@@@@@@@@@@@@@@
@@@@@@@@@@@@@@@@@@@@@@@@@@TTT.....................TTT@@@@@@@@@@@@@@@@@@@@@@@@@@
@@@@@@@@@@@@@@@@@@@@@@@@@T...........................@@@@@@@@@@@@@@@@@@@@@@@@@@
@@@@@@@@@@@@@@@@@@@@@@@@@T...........................@@@@@@@@@@@@@@@@@@@@@@@@@@
@@@@@@@@@@@@@@@@@@@@@@@@@T...........................@@@@@@@@@@@@@@@@@@@@@@@@@@
@@@@@@@@@@@@@@@@@@@@@@...................................@@@@@@@@@@@@@@@@@@@@@@
@@@@@@@@@@@@@@@@@@@@@@......TT...................TT......@@@@@@@@@@@@@@@@@@@@@@
@@@@@@@@@@@@@@@@@@@@@@.......TT.................TT.......@@@@@@@@@@@@@@@@@@@@@@
@@@@@@@@@@@@@@@@@@@@@T.......T@T...............T@T.......T@@@@@@@@@@@@@@@@@@@@@
@@TTTTTTTTTTTTTTTT@.......TTT@T................TT@TTT.......@TTTTTTTTTTTTTTTT@@
@@@@@@@@@@@@@TTTT@@.......@@@T...................T@@T.......@@TTTT@@@@@@@@@@@@@
T@@@@@@@@@@@@TTTT@@.......@T.......................TT.......@@TTTT@@@@@@@@@@@@T
T@@@@@@@@@@@@TTTT@@T......@T......TTTTTTTTTTT......TT......T@@TTTT@@@@@@@@@@@@T
T@@@@@@@@@@@TTTTT@@@TTTTTT@T......T@@@@@@@@@T......TTTTTTTT@@@TTTTT@@@@@@@@@@@T
T@@@@@@@@@@TTTTTT@@@@@@@TT@T......TTTT@@@TTTT......TTTT@@@@@@@TTTTTT@@@@@@@@@@T
T@@@@@@@@@TTTTTTT@@@@@@@..@T......TT..@@@..TT......TT..@@@@@@@TTTTTTT@@@@@@@@@T
T@@@@@@@@TTTTTTT@@@@@@@@T............T@@@T............T@@@@@@@@TTTTTTT@@@@@@@@T
T@@@@@@@TTTTTTT@@@@@@@@@@TTT......TTT@@@@@TTT......TTT@@@@@@@@@@TTTTTTT@@@@@@@T
T@@@@@@TTTTTTT@@@@@@@@@@@@@T......T@@@@@@@@@T......T@@@@@@@@@@@@@TTTTTTT@@@@@@T
T@@@@@TTTTTTT@@@@@@@@@@@@@@T......T@@@@@@@@@T......T@@@@@@@@@@@@@@TTTTTTT@@@@@T
T@@@@TTTTTTT@@@@@@@@@@@@@@@T......T@@@@@@@@@T......T@@@@@@@@@@@@@@@TTTTTTT@@@@T
T@@@TTTTTTT@@@@@@@@@@@@@@@@T......T@@@@@@@@@T......T@@@@@@@@@@@@@@@@TTTTTTT@@@T
TTTTTTTTTT@@@@@@@@@@@@@@@@@T......T@@@@@@@@@T......T@@@@@@@@@@@@@@@@@TTTTTTTTTT
TTTTTTTTT@@@@@@@@@@@@@@@@@@T......T@@@@@@@@@T......T@@@@@@@@@@@@@@@@@@TTTTTTTTT
TTTTTTTT@@@@@@@@@@@@@@@@@.............................@@@@@@@@@@@@@@@@@TTTTTTTT
TTTTTTT@@@@@@@@@@@@@@@@@@.............................@@@@@@@@@@@@@@@@@@TTTTTTT
T@@@@@@@@@@@@@@@@@@@@@@@T.............................T@@@@@@@@@@@@@@@@@@@@@@@T
T@@@@@@@@@@@@@@@@T@@@@@T...............................T@@@@@@@@@@@@@@@@@@@@@@T
@@@@@@@@@@@@@@@@@@@T......................................TT@@@@@@@@@@@@@@@@@@@
@@@@@@@@@@@@@@@@@@@T......................................TT@@@@@@@@@@@@@@@@@@@
@@@@@@@@@@@@@@@@@@@T......................................TT@@@@@@@@@@@@@@@@@@@
@@@@@@@@@@@@@@@@@@@T......................................TT@@@@@@@@@@@@@@@@@@@
@@@@@@@@@@@@@@@@@@@T......................................TT@@@@@@@@@@@@@@@@@@@
@@@@@@@@@@@@@@@@@@@T......................................TT@@@@@@@@@@@@@@@@@@@
@@@@@@@@@@@@@@@@@@@T......................................TT@@@@@@@@@@@@@@@@@@@
@@@@@@@@@@@@@@@@@@@T......................................TT@@@@@@@@@@@@@@@@@@@
@@@@@@@@@@@@@@@@@@@T......................................TT@@@@@@@@@@@@@@@@@@@
@@@@@@@@@@@@@@@@@@@T.................TTTTT................TT@@@@@@@@@@@@@@@@@@@
@@@@@@@@@@@@@@@@@@@T.................TTTTT................TT@@@@@@@@@@@@@@@@@@@
@@@@@@@@@@@@@@@@@@@T.................TTTTT................TT@@@@@@@@@@@@@@@@@@@
@@@@@@@@@@@@@@@@@@@T.................TTTTT................TT@@@@@@@@@@@@@@@@@@@
@@@@@@@@@@@@@@@@@@@T.................TTTT.................TT@@@@@@@@@@@@@@@@@@@
@@@@@@@@@@@@@@@@@@@T......................................TT@@@@@@@@@@@@@@@@@@@
@@@@@@@@@@@@@@@@@@@T......................................TT@@@@@@@@@@@@@@@@@@@
@@@@@@@@@@@@@@@@@@@T......................................TT@@@@@@@@@@@@@@@@@@@
@@@@@@@@@@@@@@@@@@@T......................................TT@@@@@@@@@@@@@@@@@@@
@@@@@@@@@@@@@@@@@@@T......................................TT@@@@@@@@@@@@@@@@@@@
@@@@@@@@@@@@@@@@@@@T......................................TT@@@@@@@@@@@@@@@@@@@
@@@@@@@@@@@@@@@@@@@T......................................TT@@@@@@@@@@@@@@@@@@@
@@@@@@@@@@@@@@@@@@@T......................................TT@@@@@@@@@@@@@@@@@@@
@@@@@@@@@@@@@@@@@@@T......................................TT@@@@@@@@@@@@@@@@@@@
@@@@@@@@@@@@@@@@@@@T......................................TT@@@@@@@@@@@@@@@@@@@
@@@@@@@@@@@@@@@@@@@T......................................TT@@@@@@@@@@@@@@@@@@@
@@@@@@@@@@@@@@@@@@@T......................................TT@@@@@@@@@@@@@@@@@@@
@@@@@@@@@@@@@@@@@@@T......................................TT@@@@@@@@@@@@@@@@@@@
@@@@@@@@@@@@@@@@@@@T......................................TT@@@@@@@@@@@@@@@@@@@
@@@@@@@@@@@@@@@@@@@T......................................TT@@@@@@@@@@@@@@@@@@@
@@@@@@@@@@@@@@@@@@@T......................................TT@@@@@@@@@@@@@@@@@@@
@@@@@@@@@@@@@@@@@@@T......................................TT@@@@@@@@@@@@@@@@@@@
@@@@@@@@@@@@@@@@@@@T......................................TT@@@@@@@@@@@@@@@@@@@
@@@@@@@@@@@@@@@@@@@T......................................TT@@@@@@@@@@@@@@@@@@@
@@@@@@@@@@@@@@@@@@@T.................TTTTT................TT@@@@@@@@@@@@@@@@@@@
@@@@@@@@@@@@@@@@@@@T.................TTTTT................TT@@@@@@@@@@@@@@@@@@@
@@@@@@@@@@@@@@@@@@@T.................TTTTT................TT@@@@@@@@@@@@@@@@@@@
@@@@@@@@@@@@@@@@@@@T.................TTTTT................TT@@@@@@@@@@@@@@@@@@@
@@@@@@@@@@@@@@@@@@@T.................TTTT.................TT@@@@@@@@@@@@@@@@@@@
@@@@@@@@@@@@@@@@@@@T......................................TT@@@@@@@@@@@@@@@@@@@
@@@@@@@@@@@@@@@@@@@T......................................TT@@@@@@@@@@@@@@@@@@@
@@@@@@@@@@@@@@@@@@@T......................................TT@@@@@@@@@@@@@@@@@@@
@@@@@@@@@@@@@@@@@@@T......................................TT@@@@@@@@@@@@@@@@@@@
@@@@@@@@@@@@@@@@@@@T......................................TT@@@@@@@@@@@@@@@@@@@
@@@@@@@@@@@@@@@@@@@T......................................TT@@@@@@@@@@@@@@@@@@@
@@@@@@@@@@@@@@@@@@@T......................................TT@@@@@@@@@@@@@@@@@@@
@@@@@@@@@@@@@@@@@@@T......................................TT@@@@@@@@@@@@@@@@@@@
@@@@@@@@@@@@@@@@@@@T......................................TT@@@@@@@@@@@@@@@@@@@
@@@@@@@@@@@@@@@@@@@T......................................TT@@@@@@@@@@@@@@@@@@@
@@@@@@@@@@@@@@@@@@@T......................................TT@@@@@@@@@@@@@@@@@@@
@@@@@@@@@@@@@@@@@@@T......................................TT@@@@@@@@@@@@@@@@@@@
@@@@@@@@@@@@@@@@@@@T......................................TT@@@@@@@@@@@@@@@@@@@
@@@@@@@@@@@@@@@@@@@T......................................TT@@@@@@@@@@@@@@@@@@@
@@@@@@@@@@@@@@@@@@@T......................................TT@@@@@@@@@@@@@@@@@@@
@@@@@@@@@@@@@@@@@@@T......................................TT@@@@@@@@@@@@@@@@@@@
@@@@@@@@@@@@@@@@@@@T......................................TT@@@@@@@@@@@@@@@@@@@
@@@@@@@@@@@@@@@@@@@T......................................TT@@@@@@@@@@@@@@@@@@@
@@@@@@@@@@@@@@@@@@@T......................................TT@@@@@@@@@@@@@@@@@@@
@@@@@@@@@@@@@@@@@@@T.................TTTTT................TT@@@@@@@@@@@@@@@@@@@
@@@@@@@@@@@@@@@@@@@T.................TTTTT................TT@@@@@@@@@@@@@@@@@@@
@@@@@@@@@@@@@@@@@@@T.................TTTTT................TT@@@@@@@@@@@@@@@@@@@
@@@@@@@@@@@@@@@@@@@T.................TTTTT................TT@@@@@@@@@@@@@@@@@@@
@@@@@@@@@@@@@@@@@@@T.................TTTT.................TT@@@@@@@@@@@@@@@@@@@
@@@@@@@@@@@@@@@@@@@T......................................TT@@@@@@@@@@@@@@@@@@@
@@@@@@@@@@@@@@@@@@@T......................................TT@@@@@@@@@@@@@@@@@@@
@@@@@@@@@@@@@@@@@@@T......................................TT@@@@@@@@@@@@@@@@@@@
@@@@@@@@@@@@@@@@@@@T......................................TT@@@@@@@@@@@@@@@@@@@
@@@@@@@@@@@@@@@@@@@T......................................TT@@@@@@@@@@@@@@@@@@@
@@@@@@@@@@@@@@@@@@@T......................................TT@@@@@@@@@@@@@@@@@@@
@@@@@@@@@@@@@@@@@@@T......................................TT@@@@@@@@@@@@@@@@@@@
@@@@@@@@@@@@@@@@@@@T......................................TT@@@@@@@@@@@@@@@@@@@
@@@@@@@@@@@@@@@@@@@T......................................TT@@@@@@@@@@@@@@@@@@@
@@@@@@@@@@@@@@@@@@@TTTTT...............................TTTTT@@@@@@@@@@@@@@@@@@@
T@@@@@@@@@@@@@@@@@@@@@@@T.............................T@@@@@@@@@@@@@@@@@@@@@@@T
TTTTTT@@@@@@@@@@@@@@@@@@@.............................@@@@@@@@@@@@@@@@@@@TTTTTT
TTTTTTT@@@@@@@@@@@@@@@@@@.............................@@@@@@@@@@@@@@@@@@TTTTTTT
TTTTTTTT@@@@@@@@@@@@@@@@@TTT......TTTTTTTTTTT......TTT@@@@@@@@@@@@@@@@@TTTTTTTT
TTTTTTTTT@@@@@@@@@@@@@@@@@@T......T@@@@@@@@@T......T@@@@@@@@@@@@@@@@@@TTTTTTTTT
T@@@TTTTTT@@@@@@@@@@@@@@@@@T......T@@@@@@@@@T......T@@@@@@@@@@@@@@@@@TTTTTT@@@T
T@@@@TTTTTT@@@@@@@@@@@@@@@@T......T@@@@@@@@@T......T@@@@@@@@@@@@@@@@TTTTTT@@@@T
T@@@@@TTTTTT@@@@@@@@@@@@@@@T......T@@@@@@@@@T......T@@@@@@@@@@@@@@@TTTTTT@@@@@T
T@@@@@@TTTTTT@@@@@@@@@@@@@@T......T@@@@@@@@@T......T@@@@@@@@@@@@@@TTTTTT@@@@@@T
T@@@@@@@TTTTTT@@@@@@@@@@@@@T......T@@@@@@@@@T......T@@@@@@@@@@@@@TTTTTT@@@@@@@T
T@@@@@@@@TTTTTT@@@@@@@@@@T..........T@@@@@T..........T@@@@@@@@@@TTTTTT@@@@@@@@T
T@@@@@@@@@TTTTTT@@@@@@@@T@TT......TT@T@@@T@TT......TT@T@@@@@@@@TTTTTT@@@@@@@@@T
T@@@@@@@@@@TTTTTT@@@@@@@@@@T......TT@@@@@@@TT......TT@@@@@@@@@TTTTTT@@@@@@@@@@T
T@@@@@@@@@@@TTTTT@@@@@@@@@@T......T@@@@@@@@@T......T@@@@@@@@@@TTTTT@@@@@@@@@@@T
T@@@@@@@@@@@@TTTT@@@T.....@T......T@@@@@@@@@T......TT.....T@@@TTTT@@@@@@@@@@@@T
T@@@@@@@@@@@@TTTT@@T......@T.......................TT......T@@TTTT@@@@@@@@@@@@T
@@@@@@@@@@@@@TTTT@@.......@TTT...................TTTT.......@@TTTT@@@@@@@@@@@@@
@@TTTTTTTTTTTTTTTT@.......TTT@T.................T@TTT.......@TTTTTTTTTTTTTTTT@@
@@@@@@@@@@@@@@@@@@@@T........T@T...............T@T........T@@@@@@@@@@@@@@@@@@@@
@@@@@@@@@@@@@@@@@@@@@T.......TT.................TT.......T@@@@@@@@@@@@@@@@@@@@@
@@@@@@@@@@@@@@@@@@@@@@......TT...................TT......@@@@@@@@@@@@@@@@@@@@@@
@@@@@@@@@@@@@@@@@@@@@@......T.....................T......@@@@@@@@@@@@@@@@@@@@@@
@@@@@@@@@@@@@@@@@@@@@@@@@T...........................@@@@@@@@@@@@@@@@@@@@@@@@@@
@@@@@@@@@@@@@@@@@@@@@@@@@T...........................@@@@@@@@@@@@@@@@@@@@@@@@@@
@@@@@@@@@@@@@@@@@@@@@@@@@T...........................@@@@@@@@@@@@@@@@@@@@@@@@@@
@@@@@@@@@@@@@@@@@@@@@@@@@TTT.......................TT@@@@@@@@@@@@@@@@@@@@@@@@@@
@@@@@@@@@@@@@@@@@@@@@@@@@@TTT.....................TTT@@@@@@@@@@@@@@@@@@@@@@@@@@
@@@@@@@@@@@@@@@@@@@@@@@@@@@T......................TT@@@@@@@@@@@@@@@@@@@@@@@@@@@
@@@@@@@@@@@@@@@@@@@@@@@@@@@@T.....................T@@@@@@@@@@@@@@@@@@@@@@@@@@@@
@@@@@@@@@@@@@@@@@@@@@@@@@@@@T.TT...............TT.T@@@@@@@@@@@@@@@@@@@@@@@@@@@@
@@@@@@@@@@@@@@@@@@@@@@@@@@@@@@TTT.............TTT@@@@@@@@@@@@@@@@@@@@@@@@@@@@@@
@@@@@@@@@@@@@@@@@@@@@@@@@@@@@@@TTTTT.......TTTTT@@@@@@@@@@@@@@@@@@@@@@@@@@@@@@@
