type octile
height 48
width 34
map
@TTTTTTTT...TTTTTTTTTTT@@@@@@@@@@@
@TT...TTT...TTTT..TTTTT@@@@@@@@@@@
@TT...............TTTTT@@@@@@@@@@@
@TT...............TTTTTTTTTTTTTTTT
@TT...............TTTTTTTTTTTTTTTT
@TT................TTT...TTTTTTTT@
@TT................TTT....TTTTTTTT
@TT................TTTT....TTTTTTT
@TT................TTTT.....TTTTTT
@TTTT..............TTTT........TTT
@TTTT..............TTTT........TTT
@TTTT...........................TT
@TTTT...........................TT
@TTTT...........................TT
@TTTT..............TTTT........TTT
@TTTTTT............TTTTTTTTTTTTTTT
@TTTTTTTT..........TTTTTTTTTTTTTTT
@TTTTTTTT..........TTT@TTTTTTTTTTT
@TTTTTTT...........TTT@TTTTTTTTTT@
@TTTTTTT...........TTT@@TTTTTTTT@@
@TTTTT............TTTTTTTTTTTTTTTT
@TTTTT............TTTTT@@@@@@@@@@@
@TTTTTT........TTTTTTTT@@@@@@@@@@@
@TTTTTT........TTTTTTTT@@@@@@@@@@@
@TTTTTT........TTTTT@@@@@@@@@@@@@@
@TTTTTT........TTTTT@@@@@@@@@@@@@@
@TT...............TT@@@@@@@@@@@@@@
@TT...............TT@@@@@@@@@@@@@@
@TT...............TT@@@@@@@@@@@@@@
@TT...............TT@@@@@@@@@@@@@@
@TT...............TT@@@@@@@@@@@@@@
@TT...............TT@@@@@@@@@@@@@@
@TT...............TT@@@@@@@@@@@@@@
@TT...............TT@@@@@@@@@@@@@@
@TT...............TT@@@@@@@@@@@@@@
@TT...............TT@@@@@@@@@@@@@@
@TT...............TT@@@@@@@@@@@@@@
@TT...............TT@@@@@@@@@@@@@@
@TTT..............TT@@@@@@@@@@@@@@
@TTTT...........TTTT@@@@@@@@@@@@@@
@TTTT...........TTTT@@@@@@@@@@@@@@
@TTTT............TTT@@@@@@@@@@@@@@
@TTTT.....T.....TTTT@@@@@@@@@@@@@@
TTTTTT..TTTTT..TTTTTT@@@@@@@@@@@@@
TTTTTTT.TTTTT.TTTTTTT@@@@@@@@@@@@@
TTTTTTTTTTTTTTTTTTTTT@@@@@@@@@@@@@
TTT@TTTTTTTTTTTTT@TTT@@@@@@@@@@@@@
TTT@@TTTTTTTTTTTT@TTT@@@@@@@@@@@@@
