type octile
height 33
width 25
map
@@@@@@@@TTTTTTTTTTTTTTTTT
@@@@@@@@TTTTTTTTTTTTTTTTT
@@@@@@@@T@TTTTTTT..TTT@TT
@@@@@@@@T@TTTTTTT.TTTTTTT
@@@@@@@@TTTTTTTTT.TTTTTTT
@@@@@@@@TTTTTTTTT..TTTTTT
@@@@@@@@TTTTTTTTT...TT..T
@@@@@@@@T.TTTTTTT.......T
@@@@@@@@T...............T
@@@@@@@@T.............TTT
@@@@@@@@T.............TTT
@@@@@@@@T.............TTT
TTTTTTTTTT............TTT
TTTTTTTTTT.............TT
@@@TT..................TT
@@@TTT.................TT
@@TTTT...................
@@TTTT...................
@@@TTT.................TT
@@@TTTTT......TTTT.....TT
TTTTTTTTTT....TTTT.....TT
@@@@@@@@TT....TTTT......T
@@@@@@@@TTT....TTT......T
@@@@@@@@TTT.............T
@@@@@@@@TTT.............T
@@@@@@@@TTT.............T
@@@@@@@@T@T.............T
@@@@@@@@TTT.............T
@@@@@@@@TT.............TT
@@@@@@@@TT.............TT
@@@@@@@@TTT.............T
@@@@@@@@TTTT.TTTTTTTTT..T
@@@@@@@@TTTTTTTTTTTTTTTTT
