type octile
height 60
width 47
map
@@@@@@@@@@@@@@TT@TTTTTTTTTTTTT@TT@@@@@@@@@@@@@@
@@@@@@@@@@@@@@TTTTTTTTTTTTTTTTTTT@@@@@@@@@@@@@@
@@@@@@@@@@@@@@TTTTTTTTTTTTTTTTTTT@@@@@@@@@@@@@@
@@@@@@@@@@@@@@TTTTTTTTTTTT@TTTTTT@@@@@@@@@@@@@@
@@@@@@@@@@@@@@TTTTTTTTTTTTTTTTTTT@@@@@@@@@@@@@@
@@@@@@@@@@@@@@TTTT..TTTTTTTTTTTTT@@@@@@@@@@@@@@
@@@@@@@@@@@@@@TTTT..TTTTTTTTTTTTT@@@@@@@@@@@@@@
@@@@@@@@@@@@@@TTTT...TT..T@@@TTTT@@@@@@@@@@@@@@
@@@@@@@@@@@@@@TTTT.......TT@@TTTT@@@@@@@@@@@@@@
@@@@@@@@@@@@@@TT..........T@@TTTT@@@@@@@@@@@@@@
@@@@@@@@@@@@@@TT..........TTTTTTT@@@@@@@@@@@@@@
@@@@@@@@@@@@@@TT..........TTTTTTT@@@@@@@@@@@@@@
@@@@@@@@@@@@@@TT..TTTT...TTTTT@TT@@@@@@@@@@@@@@
@@@@@@@@@@@@@@TTTTTTTT...TTTTTTTT@@@@@@@@@@@@@@
@@@@@@@@@@@@@@TTTTTTTT...TTTTTTTT@@@@@@@@@@@@@@
@@@@@@@@@@@@@@TTT.TTTT...TTT...TT@@@@@@@@@@@@@@
@@@@@@@@@@@@@@TTT..............TT@@@@@@@@@@@@@@
@@@@@@@@@@@@@@TTT..............TT@@@@@@@@@@@@@@
@@@@@@@@@@@@@@TTTT.............TT@@@@@@@@@@@@@@
@@@@@@@@@@@@@@TTT..TT.........TTT@@@@@@@@@@@@@@
@@@@@@@@@@@@@@TTT.TTTT........TTT@@@@@@@@@@@@@@
@@@@@@@@@@@@@@TTT.TTTT........TTT@@@@@@@@@@@@@@
@@@@@@@@@@@@@@TTTTTTTTT.......TTT@@@@@@@@@@@@@@
@@@@@@@@@@@TTTTTTTTTTTT.......TTTTT@@@@@@@@@@@@
@@@@@@@@@@@TTTTTTTTTTTT........TTTT@@@@@@@@@@@@
@@@@@@@@@@@TTTTTTTTTTTT........TTTT@@@@@@@@@@@@
TTTTTTTTTTTTTTTTTTTTT..........TTTTTTTTTTTTTTTT
TTTTTTTTTTTTTTTTTTTTT..........TTTTTTTTTTTTTTTT
@TTTTTTTT@TTTTTTT..T............TTTTT@TTTTTTTT@
TTTTTTTTT@TTTTTT................TTTTT@TTTTTTTTT
TTTTT@@@@@@TTTTT.................TTT@@@TTTTTTTT
TTTT@@@@@TTTTTTT.................TTT@@@@TTTTTTT
TTT@@@@@TTTTTTT..................TTT@@@@@TTTTTT
TTT@@@@TTTTTTT...................TTT@@@@@@@@TTT
TT@@@@TTTTT......................TTT@@@@@@@@TTT
TT@@@@TTTT.......................TTT@@T@@@@@TTT
TT@@@@TTTT.......................TTT@TT@@@@@TTT
TTT@@@@TT........................TTT@TT@@@@@TTT
TTT@@@@T.........................TTTTTT@@@@@TTT
TTTT@@@T.........................TTTTT@@@@@TTTT
TTTTT@@T.TTTT....................TTTTT@@@@TTTTT
TTTTTTTTTTTTT....................TTTTTTTTTTTTT@
@TTTTTTTTTTTT.T.................T@TTTTTTTTTTT@@
TTTTTTTTTTTTTTTT...............TTTTTTTTTTTTTTTT
TTTTTTTTTTTTTTTT..............TTTTTTTTTTTTTTTTT
@@@@@@@@@@@TTTTT...............TTTT@@@@@@@@@@@@
@@@@@@@@@@@TTTTTT..............TTTT@@@@@@@@@@@@
@@@@@@@@@@@@@@TTT..............TT@@@@@@@@@@@@@@
@@@@@@@@@@@@@@TTT..............TT@@@@@@@@@@@@@@
@@@@@@@@@@@@@@TTT............TTTT@@@@@@@@@@@@@@
@@@@@@@@@@@@@@TTTTT..........TTTT@@@@@@@@@@@@@@
@@@@@@@@@@@@@@TTTTT..........TTTT@@@@@@@@@@@@@@
@@@@@@@@@@@@@@TTTTT..........TTTT@@@@@@@@@@@@@@
@@@@@@@@@@@@@@TTTTT..........TTTT@@@@@@@@@@@@@@
@@@@@@@@@@@@@@TTTT...........TTTT@@@@@@@@@@@@@@
@@@@@@@@@@@@@@TT...............TT@@@@@@@@@@@@@@
@@@@@@@@@@@@@@TT...............TT@@@@@@@@@@@@@@
@@@@@@@@@@@@@@TT..TTTT...TTT...TT@@@@@@@@@@@@@@
@@@@@@@@@@@@@@TTTTTTTT...TTTTTTTT@@@@@@@@@@@@@@
@@@@@@@@@@@@@@@@@@TTTT...TTT@@@@@@@@@@@@@@@@@@@
