type octile
height 45
width 47
map
TTTTTTTTTTTTTTTTTTTTTTTTTTTTTTTTTTTTTTTTTTTTTTT
TTTTTTTTTTTTTTTTTTTTTTTTTTTTTTTTTTTTTTTTTTTTTTT
@TTTTTTT..TTTTTTTTTT....TTTTT@TTTTTTTTTTTTTTTT@
TTTTTT....TTTTTTTTTT..TTTTTTTTTT.TTTTTTTTTTTTTT
TTTTT.....TT@TT......TTTTTTTTTT..TTTTTTTT@TTTTT
TTTTTT...TTTT........TTTTTTTTTT...TTTTTT@@@TTTT
TTTT.....TTTT........TTTTTTTTT....TTTTTTTTTTTTT
TTTT.....TTTT...........TTTTT.....TTTTTTTTTTTTT
TTTT....................TTTTT.........TTTTTTTTT
TTTT..................................TTTTTTTTT
TTTT...T..............................TTTTTTTTT
TTTT.....TTTT.........................TTTTTTTTT
TTTT.....TTTT.........................TTTTT@TTT
TTTT.....TTTT.........................TT@@@TTTT
TTTTT.....TT..........................TT@@TTTTT
TTTTTT....TT....................TTTTTTTT@TTTTT@
@TTTTTTTT.TT.....................TTTTTTTTTTTT@@
TTTTTTTTTTTTTTTT...............TTTTTTTTTTTTTTTT
TTTTTTTTTTTTTTTT............TTTTTTTTTTTTTTTTTTT
@@@@@@@@@@@TTTTT.TTTTT...TTTTTTTTTT@@@@@@@@@@@@
@@@@@@@@@@@TTTTTTTTTTT...TTTTTTTTTT@@@@@@@@@@@@
@@@@@@@@@@@@@@TTTTTTTT...TTTTTTTTTT@@@@@@@@@@@@
@@@@@@@@@@@@@@TT..TTTT...TTT...TTTT@@@@@@@@@@@@
@@@@@@@@@@@@@@TT...............TTTT@@@@@@@@@@@@
@@@@@@@@@@@@@@TTTT.............TTTTTTTTTTTTTTTT
@@@@@@@@@@@@@@TTTT.............TTTTTTTTTTTTTTTT
@@@@@@@@@@@@@@TTTT...........TTTTTTTTTTTTTTTTT@
@@@@@@@@@@@@@@TTTT...........TTTTTTTT.TTTTTTTTT
@@@@@@@@@@@@@@TTTT...........TTT@TTT....TTTTTTT
@@@@@@@@@@@@@@TTTT............TTTTT....TTT@TTTT
@@@@@@@@@@@@@@TTTT............TTTTT....TTT@@TTT
@@@@@@@@@@@@@@TTTT............TTTTT....TTT@TTTT
@@@@@@@@@@@@@@TT................TTTT...TTTTTTTT
@@@@@@@@@@@@@@TT................TTTT....TTTTTTT
@@@@@@@@@@@@@@TT................TT......TTTTTTT
@@@@@@@@@@@@@@TT......................TTTTTTTTT
@@@@@@@@@@@@@@TTT.....................TTTTTTTTT
@@@@@@@@@@@@@@TTT.....................TTTTTTTTT
@@@@@@@@@@@@@@TT......................TTTTTTTTT
@@@@@@@@@@@@@@TT.......................TTTTTTT@
@@@@@@@@@@@@@@TT..................T...TTTTTTT@@
@@@@@@@@@@@@@@TT...............TTTTTTTTTTTTTTTT
@@@@@@@@@@@@@@TT...............TTTTTTTTTTTTTTTT
@@@@@@@@@@@@@@TT..TTTT...TTT...TTTT@@@@@@@@@@@@
@@@@@@@@@@@@@@TTTTTTTT...TTTTTTTTTT@@@@@@@@@@@@
