type octile
height 35
width 19
map
TT@TTTTTTTTTTTTT@TT
TTTTTTTTTTTTTTTTTTT
TTTTTTTTTTTTTTTTTTT
TTTTTTTTTTTTTTTTTTT
TTTTTTTTTTTTTTTTTTT
TTTTTTTTTTT@TTTTTTT
TTTTTT@@@@@@@TTTTTT
TTTTTTTTTTTTTTTTTTT
TTTT@TTTTTTTTT..TTT
TTTT@TTTTTTTTT...TT
TTT@@TTTTTTTTT...TT
TT@TTTTTTTTTTT...TT
TTTTTT...........TT
TTTTTT...........TT
TTTTT............TT
TTTTT............TT
TTT..............TT
TTT..............TT
TTT...........TTTTT
TTT...........TTTTT
TTT...........TTTTT
TTT..........TTTTTT
TT...........TTTTTT
TT...........TTTTTT
TT...........TTT@TT
TT.............TTTT
TTTTT.........TTTTT
TTTTT..........TTTT
TTTTT..........TTTT
TTTTT..........TTTT
TTTTT...........TTT
TTTTTT.......TTTTTT
TTTTTT.......TTTTTT
TTTTTTTT...TTTTTTTT
TTTTTTTT...TTTTTTTT
