type octile
height 47
width 107
map
@@@@@@@@@@@@@@TT@TTTTTTTTTTTTT@TT@@@@@TT@TTTTTTTTTTTTT@TT@@@@@TT@TTTTTTTTTTTTT@TT@@@@@@@@@@@@@@@@@@@@@@@@@@
@@@@@@@@@@@@@@TTTTTTTTTTTTTTTTTTT@@@@@TTTTTTTTTTTTTTTTTTT@@@@@TTTTTTTTTTTTTTTTTTT@@@@@@@@@@@@@@@@@@@@@@@@@@
@@@@@@@@@@@@@@TTTTTTTTTTTTTTTTTTT@@@@@TTTTTTTTTTTTTTTTTTT@@@@@TTTTTTTTTTTTTTTTTTT@@@@@@@@@@@@@@@@@@@@@@@@@@
@@@@@@@@@@@@@@TTTTTT.TTTT..TTTTTT@@@@@TTTTTT.TTTT..TTTTTT@@@@@TTTTTT.TTTT..TTTTTT@@@@@@@@@@@@@@@@@@@@@@@@@@
@@@@@@@@@@@@@@TTTTT.........TTTTT@@@@@TTTTT.........TTTTT@@@@@TTTTT.........TTTTT@@@@@@@@@@@@@@@@@@@@@@@@@@
@@@@@@@@@@@@@@TTTT...........TTTT@@@@@TTTT...........TTTT@@@@@TTTT...........TTTT@@@@@@@@@@@@@@@@@@@@@@@@@@
@@@@@@@@@@@@@@TTT.............TTT@@@@@TTT.............TTT@@@@@TTT.............TTT@@@@@@@@@@@@@@@@@@@@@@@@@@
@@@@@@@@@@@@@@TTT.............TTT@@@@@TTT.............TTT@@@@@TTT.............TTT@@@@@@@@@@@@@@@@@@@@@@@@@@
@@@@@@@@@@@@@@TT..............TTT@@@@@TT..............TTT@@@@@TT..............TTT@@@@@@@@@@@@@@@@@@@@@@@@@@
@@@@@@@@@@@@@@TT...............TT@@@@@TT...............TT@@@@@TT...............TT@@@@@@@@@@@@@@@@@@@@@@@@@@
@@@@@@@@@@@@@@TT...............TT@@@@@TT...............TT@@@@@TT...............TT@@@@@@@@@@@@@@@@@@@@@@@@@@
@@@@@@@@@@@TTTTT...............TTTTTTTTT...............TTTTTTTTT...............TTTT@@TTTT@@@@@@@@@@@@@@@@@@
@@@@@@@@@@@TTTTT...............TTTTTTTTT...............TTTTTTTTT...............TTTT@T@@@@@T@@@@@@@@@@@@@@@@
@@@@@@@@@@@TTTTTTT...........TTTTTTTTTTTTT...........TTTTTTTTTTTTT...........TTTTTTTTTTTTTT@@@@@@@@@@@@@@@@
TTTTTTTTTTTTTTTTTTTTTT..TTTTTTTTTTTTTTTTTTTTTT..TTTTTTTTTTTTTTTTTTTTTT..TTTTTTTTTTTTTTTTTTTTTTTTTTTTTTTTTTT
TTTTTTTTTTTTTTTTTTTTTT..TTTTTTTTTTTTTTTTTTTTTT..TTTTTTTTTTTTTTTTTTTTTT..TTTTTTTTTTTTTTTTTTTTTTTTTTTTTTTTTTT
@TTTTTTT.....TTTTTTTTT..TTTTTTTTTT...TTTTTTTTT..TTTTTTTTTT...TTTTTTTTT..TTTTTTTTTT...TTTTT....TT...TTTTTTT@
TTTTTT.......TTTT............TTTT....TTTT............TTTT....TTTT............TTTT....TTTT.....TT.....TTTTTT
TTTTT.........TTT............................................................................TTTT.....TTTTT
TTTT..........TTT............................................................................TTTT......TTTT
TTT...........TTT............................................................................TTTT.......TTT
TTTT..........TTT............................................................................TTTT......TTTT
TTTT..................................................................................................TTTTT
TTTT..................................................................................................TTTTT
TTTT..........TTT.....................................................................................TTTTT
TTT...........TTT............................................................................TTTT.......TTT
TTT...........TTT............................................................................TTTT.......TTT
TTTT..........TTT............................................................................TTTT......TTTT
TTTTT.........TTT.............................................................................TT......TTTTT
TTTTTT.......TTTTT...........TTTTT.......TTTTT...TTTTT.......TTTTT...........TTTTT...TTTTT....TT.....TTTTT@
@TTTTTTTT....TTTTT...........TTTTT.......TTTTTTTTTTTTT.......TTTTTTTTT..TTTTTTTTTTTTTTTTTT....TT..TTTTTTT@@
TTTTTTTTTTTTTTTTTT...........TTTTTTTTTTTTTTTTTTTTTTTTTTTTTTTTTTTTTTTTT..TTTTTTTTTTTTTTTTTTTTTTTTTTTTTTTTTTT
TTTTTTTTTTTTTTTTTTTTTT..TTTTTTTTTTTTTTTTTTTTTTTTTTTTTTTTTTTTTTTTTTTTTT..TTTTTTTTTTTTTTTTTTTTTTTTTTTTTTTTTTT
@@@@@@@@@@@TTTTTTTTTTT..TTTTTTTTTTT@@@@@TTTTTTT@TTTTTTT@@@@TTTTTT............TTTTTT@TTTTTTT@@@@@@@@@@@@@@@@
@@@@@@@@@@@TTTTTTTTTTT..TTTTTTTTTTT@@@@@T@@@@T@@T@@@@T@@@@@TTTTT...............TTTT@T@@@@T@@@@@@@@@@@@@@@@@
@@@@@@@@@@@@@@TT...............TT@@@@@@@@@TTT@@@@@TTT@@@@@@@@@TT...............TT@@@@@TTT@@@@@@@@@@@@@@@@@@
@@@@@@@@@@@@@@TT...............TT@@@@@@@@@@@@@@@@@@@@@@@@@@@@@TT...............TT@@@@@@@@@@@@@@@@@@@@@@@@@@
@@@@@@@@@@@@@@TT...............TT@@@@@@@@@@@@@@@@@@@@@@@@@@@@@TT...............TT@@@@@@@@@@@@@@@@@@@@@@@@@@
@@@@@@@@@@@@@@TT..............TTT@@@@@@@@@@@@@@@@@@@@@@@@@@@@@TT..............TTT@@@@@@@@@@@@@@@@@@@@@@@@@@
@@@@@@@@@@@@@@TTT.............TTT@@@@@@@@@@@@@@@@@@@@@@@@@@@@@TTT.............TTT@@@@@@@@@@@@@@@@@@@@@@@@@@
@@@@@@@@@@@@@@TTT.............TTT@@@@@@@@@@@@@@@@@@@@@@@@@@@@@TTT.............TTT@@@@@@@@@@@@@@@@@@@@@@@@@@
@@@@@@@@@@@@@@TTTT...........TTTT@@@@@@@@@@@@@@@@@@@@@@@@@@@@@TTTT...........TTTT@@@@@@@@@@@@@@@@@@@@@@@@@@
@@@@@@@@@@@@@@TTTTT...TTT...TTTTT@@@@@@@@@@@@@@@@@@@@@@@@@@@@@TTTTT...TTT...TTTTT@@@@@@@@@@@@@@@@@@@@@@@@@@
@@@@@@@@@@@@@@TTTTTT.TTTT..TTTTTT@@@@@@@@@@@@@@@@@@@@@@@@@@@@@TTTTTT.TTTT..TTTTTT@@@@@@@@@@@@@@@@@@@@@@@@@@
@@@@@@@@@@@@@@TTTTTTTTTTTTTTTTTTT@@@@@@@@@@@@@@@@@@@@@@@@@@@@@TTTTTTTTTTTTTTTTTTT@@@@@@@@@@@@@@@@@@@@@@@@@@
@@@@@@@@@@@@@@TTTTTTTTTTTTTTTT@TT@@@@@@@@@@@@@@@@@@@@@@@@@@@@@TTTTTTTTTTTTTTTT@TT@@@@@@@@@@@@@@@@@@@@@@@@@@
@@@@@@@@@@@@@@TT@TTTTTTTTTTTT@@TT@@@@@@@@@@@@@@@@@@@@@@@@@@@@@TT@TTTTTTTTTTTT@@TT@@@@@@@@@@@@@@@@@@@@@@@@@@
