type octile
height 46
width 84
map
@@@@@@@@@@@@@@@@@@@@@@@@@TTTTTTTTTTTTTTTTTTTTTTTTTTTTTTTTTTTTTTTTTTTTTTTTTTTTTTTTTT@
@@@@@@@@@@@@@@@@@@@@@@@@@TTTTTTTTTTTTTTTTTTTTTTTTTTTTTTTTTTTTTTTTTTTTTTTTTTTTTTTTTT@
@@@@@@@@@@@@@@@@@@@@@@@@@TTTTTTTTTTTTTTTTTTTTTTTTTTTTTTTTTTTTTTTTTTTTTTTTTTTTTTTTTT@
@@@@@@@@@@@@@@@@@@@@@@@@@TTTTTTTTT..TTTTTTTT........TTTT........TTTT..TTTTTTTTTTTTT@
@@@@@@@@@@@@@@@@@@@@@@@@@TTTTTTT.....TTTT.............................TTTTTTTTTTTTT@
@@@@@@@@@@@@@@@@@@@@@@@@@TTTTTT.......................................TTTTTTTTTTTTT@
@@@@@@@@@@@@@@@@@@@@@@@@@TTTTT........................................TTTTTTTTTTTTT@
@@@@@@@@@@@@@@@@@@@@@@@@@TTTT.........................................TTTTTTTTTTTTT@
@@@@@@@@@@@@@@@@@@@@@@@@@TTTT.............................TTTT.........TTTTTTTTTTTTT
@@@@@@@@@@@@@@@@@@@@@@@@@TTT.............................TTTTTT........TTTTTTTTTTTT@
@@@@@@@@@@@@@@@@@@@@@@@@@TTT.............................TTTTTT............TTTTTTTT@
@@@@@@@@@@@@@@@@@@@@@@@@TTTT.............................TTTTTT............TTTTTTTT@
TTTTTTTTTTTTTTTTTTTTTTTTTTTTT............................TTTTTT............TTTTTTTT@
TTTTTTTTTTTTTTTTTTTTTTTTTTTTT.............................TTTT..............TTTTTTT@
TTTTTTTTTTTTTTTTTTTTTTTTTTTTT...................................................TTT@
TTTTT.......TTTTTTTT...........................................................TTTT@
TTTT.........TTTT..............................................................TTTT@
TTT............................................................................TTTT@
TT.............................................................................TTTT@
TT..............................................................................TTT@
TT............................................................................TTTTT@
...............................................................TTTTTTTTT......TTTTT@
...............................................................TTTTTTTTT..TT..TTTTT@
...............................................................TTTTTTTTT..T@T.TTTTT@
...............................................................TTTTTTTTT..TT..TTTTT@
TT............................................................................TTTTT@
TT..............................................................................TTT@
TT.............................................................................TTTT@
TTT............................................................................TTTT@
TTTT...........................................................................TTTT@
TTTTT...........TTTT.....TTT...................................................TTTT@
TTTTTTTTTTTTTTTTTTTTTTTTTTTT....................................................TTT@
TTTTTTTTTTTTTTTTTTTTTTTTTTTT..............................TTTT..............TTTTTTT@
TTTTTTTTTTTTTTTTTTTTTTTTTTTT.............................TTTTTT............TTTTTTTT@
@@@@@@@@@@@@@@@@@@@@@@@@TTTT.............................TTTTTT............TTTTTTTT@
@@@@@@@@@@@@@@@@@@@@@@@@@TTT.............................TTTTTT.........TTTTTTTTTTT@
@@@@@@@@@@@@@@@@@@@@@@@@@TTT.............................TTTTTT.......TTTTTTTTTTTTT@
@@@@@@@@@@@@@@@@@@@@@@@@@TTTT.............................TTTT........TTTTTTTTTTTTTT
@@@@@@@@@@@@@@@@@@@@@@@@@TTTT........................................TTTTTTTTT@TTTTT
@@@@@@@@@@@@@@@@@@@@@@@@@TTTT........................................TTTTTTTTT@TTTT@
@@@@@@@@@@@@@@@@@@@@@@@@@TTTTT.......................................TTTTTTTTTTTTTT@
@@@@@@@@@@@@@@@@@@@@@@@@@TTTTTT......................................TTTTTTTTTTTTTT@
@@@@@@@@@@@@@@@@@@@@@@@@@TTTTTTTTT......TTTT........TTTT........TTTT..TTTTTTTTTTTTT@
@@@@@@@@@@@@@@@@@@@@@@@@@TTTTTTTTTTTTTTTTTTTTTTTTTTTTTTTTTTTTTTTTTTTTTTTTTTTTTTTTTT@
@@@@@@@@@@@@@@@@@@@@@@@@@TTTTTTTTTTTTTTTTTTTTTTTTTTTTTTTTTTTTTTTTTTTTTTTTTTTTTTTTTT@
@@@@@@@@@@@@@@@@@@@@@@@@@TTTTTTTTTTTTTTTTTTTTTTTTTTTTTTTTTTTTTTTTTTTTTTTTTTTTTTTTTT@
