type octile
height 22
width 28
map
@@@@@@@@@@TTTTTTTTT@@@@@@@@@
@@@@@@@@@@TT......TTTT@@@@@@
@@@@@@@@@@TT.......TTTTTT@T@
@@TTTTTTTTTT.....TTTTTTTTTT@
@@TT.............TTTTTTTTTT@
@@TT.............TTT...TTTT@
@@TT.....................TT@
@@TT.....................TT@
@@TT.....................TT@
T@TT.....................TT@
@@TT.....................TTT
T@TTT....................TTT
@@TTT.....T.TTTT.........TTT
@@TTT....TTTTTTT...........@
@@TTT....TTTTTTT...........@
@@TTT.....T@TTTT...........@
@@TTT.....T@TTTT....TTTTTTT@
@@TTT....TT@TTTT...TTTTTTTT@
@@TTTTTTTTTTTTTTTTTTTTTTTTT@
@@@@@@@TTTTTT@@@@@@@@@@@@@@@
@@@@@@@@T@@@T@@@@@@@@@@@@@@@
@@@@@@@@@@T@@@@@@@@@@@@@@@@@
