type octile
height 49
width 182
map
@@@@@@@@@@@@@@@@@@@@@@@@@@@@@@@@@@@@@@@@@@@@@@@@@@@@@@@@@@@@@@@@@@@@@@@@@@@@@@@@@@@@@@@@@@@@@@@@@@@@@TTTT@@@@@@@@@@@@@@.TTTTTTTTTTTTTTTTTTTTTTTTTTTTTTTTTTTTTTTTTTTTTTTTTTTTTT@@@@@@@@
TTTTTTTTTTTTTTTTTTTTTTTTTTTTTTTTTTTTTTTTTTTTTTTTTTTTTTT@@@@TTTTTTTTTT@@@@@@TTTTTTTTTT@@@@@@TTTTTTTTTTTTTT@@@@@@@@@@@@@@TTTTTTTTTTTTTTTTTTTTTTTTTTTTTTTTTTTTTTTTTTTTTTTTTTTTTTT@@@@@@@@
T.....TTT..TTTTT..............TTT.............TTT.....T@@@@TTTTTTTTTT@@@@@@TTTTTTTTTT@@@@@@T........TTTTT@@@@@@@@@@@@@@TTTTTTT......TTTTTTTTTT.......TTTTTTTTT.......TTTTT...T@@@@@@@@
T..........TTTTT......................................T@@@@T........T@@@@@@TTTTTTTTTT@@@@@@T........TTTTT@@@@@@@@@@@@@@TTTTTT........TTTTTTTT........TTTTTTTTT........TTTT...T@@@@@@@@
T.....................................................T@TTT.........TTTTTTT.TTTTTTTTTTTTTTTT..........TTT@@@@@@@@@@@@@@T...............TTTT.............TTTT.................T@@@@@@@@
T......TTTT.....TTTT.........TTTT.....................T@TTT.........TTTTTTTTTTTTTTTTTTTTTTTT..........TTT@@@@@@@@@@@@@@T.................................TTT.................T@@@@@@@@
TTT....TTT......TTTTT........TTTTT....................T@TTT.........TTTTTTT.TTT.....TTTTTTTT............T@@@@@@@@@@@@@@T.....................................................T@@@@@@@@
TTT..............TTTT........TTTTT............TTT.....T@TTT...........TTT..............TTT..............T@@@@@@@@@@@@@@T.....................................................T@@@@@@@@
TTT..............TTT.........TTTTT............TTT....TTTTTT...........TTT...........TT.TTT..............T@@@@@@@@@@@@@@T.....................................................T@@@@@@@@
TTT..............TTT.........TTTTT............TTT....TTTTTT...........TTT.........TTTT.TTT..............T@@@@@@@@@@@@@@T.....................................................T@@@@@@@@
TTT..............TTT.........TTTTT...................TTTTTT...........TTT.........TT.TTTTT..............T@@@@@@@@@@@@@@T.....................................................T@@@@@@@@
TTT..............TTT.........TTTTTT...................TTTTT........................TT...................T@@@@@@@@@@@@@@T.....................................................T@@@@@@@@
T................TTTTT.......TTTTTT...................TTTTT.............................................T@@@@@@@@@@@@@@T................TTT..................................T@@@@@@@@
T................TTTTT........TTT.....................TTTTT.............................................T@@@@@@@@@@@@@@T...............TTTT..................................T@@@@@@@@
T......TTTTT.....TTTTT........TTT.....................TTTTT.............................................T@@@@@@@@@@@@@@TTTTTTT.......TTTTTT..................................T@@@@@@@@
T......TTTTT.....TTTTT........TTT....................TTTTTT...........................................TTT@@@@@@@@@@@@@@TTTTTTT......TTTTTTT.................................TT@@@@@@@@
TTT..............TTTTT........TTT....................TTTTTT...........................................TTTTT..TTTTTT.TTTTTTTTTT......TTTTTTT.................................TTTTT..TTT
TTT.TTTTTTTT.....TTTTT........TTT....................TTTTTT............................................TTTTTTTTTTTTTTTTTTTTTT........TTTTT..................................TTTTTT.TTT
TTT.TTTTTTTT.....TTTTT........TTTT....................TTTTT..............................................TTTTTTTTTTTTTT.......................................................TTTTTTTT
T...TTTTTTTT.....TTT..........TTT.....................TTTTT...............................................TTTTTTTTTTT...........................................................TTTTTT
T...TTTTT.............................................TTTTT.................................................TTTTTTTT.............................................................TTTTT
T...TTTTT.............................................TTT...........................................................................................................................TT
T...TTTTT.............................................TTT...........................................................................................................................TT
T..TTTTTT...........................................................................................................................................................................TT
T..TTTTTT...........................................................................................................................................................................TT
T..TTTTTT...........................................................................................................................................................................TT
T...TTTTT.............................................TTT...........................................................................................................................TT
T...TTTTT.............................................TTT...........................................................................................................................TT
T...TTTTT.TT..........................................TTTTT..................................................TTTTTT................................................................TTT
T...TTTTTTTTT....TTT..........TTTT....................TTTTT.................................................TTTTTTTTT............................................................TTTTT
TTT.TTTTTTTT.....TTT..........TTTT....................TTTTT...............................................TTTTTTTTTTTTT........................................................TTTTTTT
TTT...TTTTTT.....TTT..........TTTTTT.................TTTTTT.............................................TTTTTTTTTTTTTTTTT....................................................TTTTTTTTT
TTT..............TTT..........TTTTTT.................TTTTTT...........................................TTTTTTTTTTTTT.TTTTTTTTTT.......TTTTTT.................................TTTTTT.TTT
TTT..............TTT..........TTTTT..................TTTTTT...........................................TTT@@@@@@@@@@@@@@TTTTTTT......TTTTTTT.................................TT@@@@@@@@
TTT..............TTT..........TTTTTTT.................TTTTT............................................TT@@@@@@@@@@@@@@TTTTTTT......TTTTTTT.................................TT@@@@@@@@
TTT....TTTTT.....TTT..........TTTTTTT.................TTTTT.............................................T@@@@@@@@@@@@@@TTTTTT........TTTTTT..................................T@@@@@@@@
TTT....TTTTT.....TTT..........TTTTT...................TTTTT.............................................T@@@@@@@@@@@@@@T...............TTTT..................................T@@@@@@@@
TTT..............TTTTTT.TTTTTTTTTTTTTTTTTTTTTTT.TTTTTTTTTTT.............................................T@@@@@@@@@@@@@@T................TTT..................................T@@@@@@@@
TTT..............TTTTTT.TTTTTTTTTTTTTTTTTTTTTTTTTTTTTTTTTTT...........................TTTT..............T@@@@@@@@@@@@@@T.....................................................T@@@@@@@@
TTTTTTTT@@@@@@@@@@@@@@@@@@@@@@@@@@@@@@@@@@@@@@@TTTTTTTTTTTT...........TTT.............TTTT..............T@@@@@@@@@@@@@@T.....................................................T@@@@@@@@
@@@@@@@@@@@@@@@@@@@@@@@@@@@@@@@@@@@@@@@@@@@@@@@@@@@@@@@TTTT...........TTT.............TTTT..............T@@@@@@@@@@@@@@T.....................................................T@@@@@@@@
@@@@@@@@@@@@@@@@@@@@@@@@@@@@@@@@@@@@@@@@@@@@@@@@@@@@@@@@TTT...........TTT.............TTTT..............T@@@@@@@@@@@@@@T.....................................................T@@@@@@@@
@@@@@@@@@@@@@@@@@@@@@@@@@@@@@@@@@@@@@@@@@@@@@@@@@@@@@@@@TTT...........TTT...TTT..TTT..TTTT..............T@@@@@@@@@@@@@@T.....................................................T@@@@@@@@
@@@@@@@@@@@@@@@@@@@@@@@@@@@@@@@@@@@@@@@@@@@@@@@@@@@@@@@@TTT...........TTT...TTTTTTTT..TTTT............TTT@@@@@@@@@@@@@@T.....................................................T@@@@@@@@
@@@@@@@@@@@@@@@@@@@@@@@@@@@@@@@@@@@@@@@@@@@@@@@@@@@@@@@@TTT...........TTT...TTTTTTTT..TTTT............TTT@@@@@@@@@@@@@@T................TT..............TTT..................T@@@@@@@@
@@@@@@@@@@@@@@@@@@@@@@@@@@@@@@@@@@@@@@@@@@@@@@@@@@@@@@@@@@@..........@@@@@@.TTTTTTTT.@@@@@@...........TTT@@@@@@@@@@@@@@T...............TTTT.............TTTT.................T@@@@@@@@
@@@@@@@@@@@@@@@@@@@@@@@@@@@@@@@@@@@@@@@@@@@@@@@@@@@@@@@@@@@T........T@@@@@@TTTTTTTTTT@@@@@@T........TTTTT@@@@@@@@@@@@@@TTTTTTT.......TTTTTTTTT.......TTTTTTTTT........TTTT...T@@@@@@@@
@@@@@@@@@@@@@@@@@@@@@@@@@@@@@@@@@@@@@@@@@@@@@@@@@@@@@@@@@@@TTTTTTTTTT@@@@@@TTTTTTTTTT@@@@@@TTTTTTTTTTTTTT@@@@@@@@@@@@@@TTTTTTTTT...TTTTTTTTTTTTTTTTTTTTTTTTTTTTTTTTTTTTTTTTTTT@@@@@@@@
@@@@@@@@@@@@@@@@@@@@@@@@@@@@@@@@@@@@@@@@@@@@@@@@@@@@@@@@@@@TTTTTTTTTT@@@@@@TTTTTTTTTT@@@@@@TTTTTTTTTTTTTT@@@@@@@@@@@@@@TTTTTTTTTTTTTTTTTTTTTTTTTTTTTTTTTTTTTTTTTTTTTTTTTTTTTTT@@@@@@@@
